2,KECAMATAN,3,BAKONGAN,0,0,0
2,KECAMATAN,248,KOTA BAHAGIA,1172,1389,2561
2,KECAMATAN,236,LABUHAN HAJI TIMUR,0,0,0
2,KECAMATAN,222,LABUHAN HAJI BARAT,3584,3200,6784
2,KECAMATAN,212,TRUMON TIMUR,0,0,0
2,KECAMATAN,204,KLUET TIMUR,2552,1689,4241
2,KECAMATAN,190,KLUET TENGAH,0,0,0
2,KECAMATAN,182,BAKONGAN TIMUR,1027,1230,2257
2,KECAMATAN,161,PASIE RAJA,3470,2925,6395
2,KECAMATAN,148,TRUMON,950,1174,2124
2,KECAMATAN,132,TAPAKTUAN,7752,3401,11153
2,KECAMATAN,116,SAWANG,4676,2743,7419
2,KECAMATAN,87,SAMADUA,6333,2476,8809
2,KECAMATAN,64,MEUKEK,5016,3676,8692
2,KECAMATAN,47,LABUHAN HAJI,0,0,0
2,KECAMATAN,29,KLUET SELATAN,2779,3259,6038
2,KECAMATAN,9,KLUET UTARA,5194,5108,10302
2,KECAMATAN,259,TRUMON TENGAH,0,0,0
1,KABUPATEN/KOTA,269,ACEH TENGGARA,44505,32270,76775
2,KECAMATAN,270,LAWE ALAS,7473,2030,9503
2,KECAMATAN,632,TANOH ALAS,1398,881,2279
2,KECAMATAN,613,LAWE SUMUR,0,0,0
2,KECAMATAN,590,DELENG POKHKISEN,0,0,0
2,KECAMATAN,564,KETAMBE,3705,2347,6052
2,KECAMATAN,536,BABUL RAHMAH,0,0,0
2,KECAMATAN,516,SEMADAM,0,0,0
2,KECAMATAN,492,BUKIT TUSAM,0,0,0
2,KECAMATAN,467,LAWE BULAN,6165,2590,8755
2,KECAMATAN,438,DARUL HASANAH,0,0,0
2,KECAMATAN,416,BABUL MAKMUR,0,0,0
2,KECAMATAN,397,BADAR,0,0,0
2,KECAMATAN,369,BABUSSALAM,0,0,0
2,KECAMATAN,335,BAMBEL,7774,2528,10302
2,KECAMATAN,647,LEUSER,0,0,0
1,KABUPATEN/KOTA,671,ACEH TIMUR,26515,10376,36891
2,KECAMATAN,672,DARUL AMAN,2354,3297,5651
2,KECAMATAN,1037,IDI TUNONG,1746,1748,3494
2,KECAMATAN,1063,BANDA ALAM,960,1731,2691
2,KECAMATAN,1080,PEUDAWA,1637,1673,3310
2,KECAMATAN,1098,PEUREULAK TIMUR,1391,2678,4069
2,KECAMATAN,1119,PEUREULAK BARAT,2282,2048,4330
2,KECAMATAN,1135,SUNGAI RAYA,1477,1872,3349
2,KECAMATAN,1149,SIMPANG JERNIH,1300,544,1844
2,KECAMATAN,1158,DARUL IHSAN,1155,1195,2350
2,KECAMATAN,1175,DARUL FALAH,442,1084,1526
2,KECAMATAN,1187,IDI TIMUR,824,1153,1977
2,KECAMATAN,1023,INDRA MAKMU,4063,1733,5796
2,KECAMATAN,996,MADAT,3393,3941,7334
2,KECAMATAN,718,JULOK,3589,4736,8325
2,KECAMATAN,756,IDI RAYEUK,5577,5106,10683
2,KECAMATAN,792,BIREM BAYEUN,8471,3382,11853
2,KECAMATAN,820,SERBAJADI,1893,1267,3160
2,KECAMATAN,838,NURUSSALAM,2570,3702,6272
2,KECAMATAN,870,PEUREULAK,4870,6850,11720
2,KECAMATAN,909,RANTAU SELAMAT,1835,1942,3777
2,KECAMATAN,924,SIMPANG ULIM,2492,2775,5267
2,KECAMATAN,948,RANTAU PEUREULAK,5339,3238,8577
2,KECAMATAN,972,PANTE BIDARI,2626,4052,6678
2,KECAMATAN,1201,PEUNARON,2315,1801,4116
1,KABUPATEN/KOTA,1207,ACEH TENGAH,64601,63548,128149
2,KECAMATAN,1208,LINGE,2239,3127,5366
2,KECAMATAN,1459,CELALA,1747,3106,4853
2,KECAMATAN,1440,KUTE PANANG,1463,2745,4208
2,KECAMATAN,1420,KEBAYAKAN,3047,4750,7797
2,KECAMATAN,1394,KETOL,3311,3819,7130
2,KECAMATAN,1386,JAGONG JEGET,3274,1968,5242
2,KECAMATAN,1362,BINTANG,1225,4038,5263
2,KECAMATAN,1332,PEGASING,3528,6690,10218
2,KECAMATAN,1322,ATU LINTANG,1972,1413,3385
2,KECAMATAN,1307,RUSIP ANTARA,1525,2194,3719
2,KECAMATAN,1295,BIES,1865,2243,4108
2,KECAMATAN,1267,BEBESEN,6936,9334,16270
2,KECAMATAN,1233,SILIH NARA,4403,7420,11823
2,KECAMATAN,1476,LAUT TAWAR,3987,5035,9022
1,KABUPATEN/KOTA,1492,ACEH BARAT,40522,57882,98404
2,KECAMATAN,1493,JOHAN PAHWALAN,13649,10052,23701
2,KECAMATAN,1778,WOYLA TIMUR,1345,1281,2626
2,KECAMATAN,1753,WOYLA BARAT,2425,1714,4139
2,KECAMATAN,1726,MEUREUBO,5705,5686,11391
2,KECAMATAN,1700,PANTE CEUREUMEN,3245,2270,5515
2,KECAMATAN,1672,ARONGAN LAMBALEK,2261,3316,5577
2,KECAMATAN,1654,BUBON,1732,1800,3532
2,KECAMATAN,1621,SAMATIGA,3904,4284,8188
2,KECAMATAN,1577,WOYLA,4000,3208,7208
2,KECAMATAN,1559,SUNGAI MAS,1218,845,2063
2,KECAMATAN,1515,KAWAY XVI,5921,4506,10427
2,KECAMATAN,1804,PANTON REU,1930,1100,3030
1,KABUPATEN/KOTA,1824,ACEH BESAR,47335,40062,87397
2,KECAMATAN,1825,LHOONG,2779,2419,5198
2,KECAMATAN,2294,KOTA JANTHO,1967,2018,3985
2,KECAMATAN,2308,KOTA COT GLIE,3272,3379,6651
2,KECAMATAN,2341,KUTA MALAKA,2158,1042,3200
2,KECAMATAN,2357,SIMPANG TIGA,1857,1176,3033
2,KECAMATAN,2376,DARUL KAMAL,1819,1599,3418
2,KECAMATAN,2391,BAITUSSALAM,3779,3160,6939
2,KECAMATAN,2418,LEUPUNG,631,763,1394
2,KECAMATAN,2263,PULO ACEH,1127,1301,2428
2,KECAMATAN,2233,DARUSSALAM,5537,3722,9259
2,KECAMATAN,2185,KUTA BARO,6132,5241,11373
2,KECAMATAN,1854,LHOKNGA,4580,3111,7691
2,KECAMATAN,1883,INDRAPURI,6377,3906,10283
2,KECAMATAN,1936,SEULIMEUM,4693,5158,9851
2,KECAMATAN,1984,MONTASIK,6373,3074,9447
2,KECAMATAN,2024,SUKAMAKMUR,4189,3170,7359
2,KECAMATAN,2060,DARUL IMARAH,11484,7981,19465
2,KECAMATAN,2093,PEUKAN BADA,3778,3662,7440
2,KECAMATAN,2120,MESJID RAYA,3001,3257,6258
2,KECAMATAN,2134,INGIN JAYA,8026,6351,14377
2,KECAMATAN,2425,BLANG BINTANG,3053,2148,5201
1,KABUPATEN/KOTA,2452,PIDIE,86612,67638,154250
2,KECAMATAN,2453,BATEE,0,0,0
2,KECAMATAN,2929,SAKTI,0,0,0
2,KECAMATAN,2979,SIMPANG TIGA,4660,5611,10271
2,KECAMATAN,3032,TANGSE,5198,6186,11384
2,KECAMATAN,3081,KEUMALA,1032,2969,4001
2,KECAMATAN,3099,MUTIARA TIMUR,4938,8418,13356
2,KECAMATAN,3164,MANE,976,1397,2373
2,KECAMATAN,3169,GLUMPANG BARO,1565,2941,4506
2,KECAMATAN,2864,PIDIE,0,0,0
2,KECAMATAN,2815,PEUKAN BARO,0,0,0
2,KECAMATAN,2750,PADANG TIJI,4002,5167,9169
2,KECAMATAN,2482,DELIMA,0,0,0
2,KECAMATAN,2527,GEUMPANG,785,1158,1943
2,KECAMATAN,2533,GEULUMPANG TIGA,0,0,0
2,KECAMATAN,2568,INDRA JAYA,3618,5734,9352
2,KECAMATAN,2618,KEMBANG TANJONG,3411,5241,8652
2,KECAMATAN,2664,KOTA SIGLI,3518,3742,7260
2,KECAMATAN,2680,MILA,1760,1958,3718
2,KECAMATAN,2701,MUARA TIGA,4865,1867,6732
2,KECAMATAN,2720,MUTIARA,3270,4973,8243
2,KECAMATAN,3191,TITEUE,1110,1353,2463
1,KABUPATEN/KOTA,3205,ACEH UTARA,44708,58715,103423
2,KECAMATAN,3206,BAKTIYA,7176,6433,13609
2,KECAMATAN,3837,NISAM,4535,1928,6463
2,KECAMATAN,3867,COT GIREK,6352,2450,8802
2,KECAMATAN,3892,LANGKAHAN,4194,3819,8013
2,KECAMATAN,3916,BAKTIYA BARAT,2948,3224,6172
2,KECAMATAN,3943,PAYA BAKONG,2984,2449,5433
2,KECAMATAN,3983,NIBONG,2514,1675,4189
2,KECAMATAN,4004,SIMPANG KRAMAT,2801,1284,4085
2,KECAMATAN,4021,LAPANG,1181,1280,2461
2,KECAMATAN,4033,PIRAK TIMUR,1775,1507,3282
2,KECAMATAN,4057,GEUREDONG PASE,1563,533,2096
2,KECAMATAN,4069,BANDA BARO,1705,695,2400
2,KECAMATAN,3797,SAWANG,7866,3931,11797
2,KECAMATAN,3730,TANAH PASIR,1867,1427,3294
2,KECAMATAN,3264,DEWANTARA,8254,4449,12703
2,KECAMATAN,3280,KUTA MAKMUR,6314,3703,10017
2,KECAMATAN,3320,LHOKSUKON,9549,7667,17216
2,KECAMATAN,3397,MATANGKULI,3872,3445,7317
2,KECAMATAN,3447,MUARA BATU,5837,2986,8823
2,KECAMATAN,3472,MEURAH MULIA,3965,3782,7747
2,KECAMATAN,3523,SAMUDERA,6294,3771,10065
2,KECAMATAN,3564,SEUNUDDON,6338,2800,9138
2,KECAMATAN,3598,SYAMTALIRA ARON,4374,3121,7495
2,KECAMATAN,3633,SYAMTALIRA BAYU,4800,2801,7601
2,KECAMATAN,3672,TANAH LUAS,6213,4120,10333
2,KECAMATAN,4079,NISAM ANTARA,1611,937,2548
1,KABUPATEN/KOTA,4086,SIMEULUE,116882,76217,193099
2,KECAMATAN,4087,SIMEULUE TENGAH,0,0,0
2,KECAMATAN,83455,TEUPAH TENGAH,0,0,0
2,KECAMATAN,4224,ALAPAN,0,0,0
2,KECAMATAN,4204,TEUPAH SELATAN,0,0,0
2,KECAMATAN,4189,SIMEULUE BARAT,0,0,0
2,KECAMATAN,4178,TELUK DALAM,0,0,0
2,KECAMATAN,4148,SIMEULUE TIMUR,0,0,0
2,KECAMATAN,4129,TEUPAH BARAT,0,0,0
2,KECAMATAN,4112,SALANG,0,0,0
2,KECAMATAN,83456,SIMEULUE CUT,0,0,0
1,KABUPATEN/KOTA,4233,ACEH SINGKIL,0,0,0
2,KECAMATAN,4234,PULAU BANYAK,838,574,1412
2,KECAMATAN,4355,KUALA BARU,569,413,982
2,KECAMATAN,4348,SINGKOHOR,1795,1135,2930
2,KECAMATAN,4336,SURO MAKMUR,1233,1698,2931
2,KECAMATAN,4329,DANAU PARIS,1054,1273,2327
2,KECAMATAN,4321,SINGKIL UTARA,2008,1810,3818
2,KECAMATAN,4311,KOTA BAHARU,1627,1031,2658
2,KECAMATAN,4285,GUNUNG MERIAH,9059,5549,14608
2,KECAMATAN,4268,SINGKIL,4907,2480,7387
2,KECAMATAN,4242,SIMPANG KANAN,3821,2613,6434
2,KECAMATAN,4360,PULAU BANYAK BARAT,370,654,1024
1,KABUPATEN/KOTA,4362,BIREUEN,27281,19230,46511
2,KECAMATAN,4363,SAMALANGA,6185,3652,9837
2,KECAMATAN,4925,PEUSANGAN SELATAN,3085,2060,5145
2,KECAMATAN,4903,PEUSANGAN SIBLAH KRUENG,2839,1838,4677
2,KECAMATAN,4882,KUALA,4215,2235,6450
2,KECAMATAN,4858,KOTA JUANG,10759,5952,16711
2,KECAMATAN,4835,PEULIMBANG,2180,2342,4522
2,KECAMATAN,4793,SIMPANG MAMPLAM,4639,4356,8995
2,KECAMATAN,4746,JANGKA,5432,4381,9813
2,KECAMATAN,4709,JULI,7180,4581,11761
2,KECAMATAN,4689,PANDRAH,2018,1335,3353
2,KECAMATAN,4648,GANDAPURA,6515,2592,9107
2,KECAMATAN,4620,MAKMUR,3523,2013,5536
2,KECAMATAN,4550,PEUSANGAN,11179,7392,18571
2,KECAMATAN,4507,JEUMPA,7113,4486,11599
2,KECAMATAN,4454,PEUDADA,5264,5031,10295
2,KECAMATAN,4410,JEUNIEB,7878,3096,10974
2,KECAMATAN,4947,KUTA BLANG,5773,2745,8518
1,KABUPATEN/KOTA,4989,ACEH BARAT DAYA,95777,60087,155864
2,KECAMATAN,4990,BLANG PIDIE,0,0,0
2,KECAMATAN,5027,MANGGENG,3479,2648,6127
2,KECAMATAN,5045,SUSOH,0,0,0
2,KECAMATAN,5074,KUALA BATEE,3972,3536,7508
2,KECAMATAN,5093,BABAH ROT,0,0,0
2,KECAMATAN,5104,LEMBAH SABIL,0,0,0
2,KECAMATAN,5118,SETIA,1239,1627,2866
2,KECAMATAN,5127,JEUMPA,0,0,0
1,KABUPATEN/KOTA,5138,GAYO LUES,8690,7811,16501
2,KECAMATAN,5139,KUTAPANJANG,0,0,0
2,KECAMATAN,5265,PANTAN CUACA,0,0,0
2,KECAMATAN,5254,BLANGJERANGO,0,0,0
2,KECAMATAN,5244,PUTERI BETUNG,0,0,0
2,KECAMATAN,5231,BLANGPEGAYON,0,0,0
2,KECAMATAN,5221,DABUN GELANG,0,0,0
2,KECAMATAN,5211,PINING,0,0,0
2,KECAMATAN,5187,TERANGUN,0,0,0
2,KECAMATAN,5173,RIKIT GAIB,0,0,0
2,KECAMATAN,5152,BLANGKEJEREN,0,0,0
2,KECAMATAN,5275,TERIPE JAYA,0,0,0
1,KABUPATEN/KOTA,5286,ACEH JAYA,0,0,0
2,KECAMATAN,5287,TEUNOM,3345,3199,6544
2,KECAMATAN,5324,KRUENG SABEE,0,0,0
2,KECAMATAN,5342,SETIA BAKTI,1729,1593,3322
2,KECAMATAN,5356,SAMPOINIET,1453,1618,3071
2,KECAMATAN,5394,JAYA,5321,2147,7468
2,KECAMATAN,5443,PANGA,1458,1992,3450
2,KECAMATAN,83451,INDRA JAYA,2307,1233,3540
2,KECAMATAN,83452,DARUL HIKMAH,1779,1271,3050
2,KECAMATAN,83453,PASIE RAYA,0,0,0
1,KABUPATEN/KOTA,5463,NAGAN RAYA,17392,13053,30445
2,KECAMATAN,5464,KUALA,4447,4269,8716
2,KECAMATAN,83454,TRIPA MAKMUR,1932,1612,3544
2,KECAMATAN,5671,TADU RAYA,3129,3235,6364
2,KECAMATAN,5654,KUALA PESISIR,3722,3727,7449
2,KECAMATAN,5634,SUKA MAKMUE,2077,2852,4929
2,KECAMATAN,5581,DARUL MAKMUR,10555,9416,19971
2,KECAMATAN,5552,BEUTONG,2308,4007,6315
2,KECAMATAN,5517,SEUNAGAN TIMUR,3125,4321,7446
2,KECAMATAN,5482,SEUNAGAN,3480,4764,8244
2,KECAMATAN,83457,BEUTONG ATEUH BANGGALANG,308,553,861
1,KABUPATEN/KOTA,5694,ACEH TAMIANG,35083,38756,73839
2,KECAMATAN,5695,MANYAK PAYED,7261,4187,11448
2,KECAMATAN,5899,TENGGULUN,3867,2994,6861
2,KECAMATAN,5883,BANDAR PUSAKA,3303,2136,5439
2,KECAMATAN,5872,BANDA MULIA,3180,1373,4553
2,KECAMATAN,5855,RANTAU,10874,4766,15640
2,KECAMATAN,5845,TAMIANG HULU,5532,2790,8322
2,KECAMATAN,5829,KEJURUAN MUDA,9005,5757,14762
2,KECAMATAN,5823,KOTA KUALASIMPANG,4391,2982,7373
2,KECAMATAN,5798,SERUWAY,6817,4801,11618
2,KECAMATAN,5766,KARANG BARU,12432,5320,17752
2,KECAMATAN,5732,BENDAHARA,5617,2931,8548
2,KECAMATAN,5905,SEKERAK,1990,1106,3096
1,KABUPATEN/KOTA,5920,BENER MERIAH,74269,41143,115412
2,KECAMATAN,5921,TIMANG GAJAH,0,0,0
2,KECAMATAN,6139,MESIDAH,635,1445,2080
2,KECAMATAN,6126,BENER KELIPAH,759,1531,2290
2,KECAMATAN,6098,PERMATA,0,0,0
2,KECAMATAN,6081,SYIAH UTAMA,300,653,953
2,KECAMATAN,6045,BANDAR,0,0,0
2,KECAMATAN,6017,WIH PESAM,5304,5670,10974
2,KECAMATAN,5976,BUKIT,0,0,0
2,KECAMATAN,5952,PINTU RIME GAYO,1965,3742,5707
2,KECAMATAN,6155,GAJAH PUTIH,0,0,0
1,KABUPATEN/KOTA,6166,PIDIE JAYA,8963,13041,22004
2,KECAMATAN,6167,MEUREUDU,3636,4771,8407
2,KECAMATAN,6198,ULIM,1917,3794,5711
2,KECAMATAN,6229,JANGKA BUYA,1195,2071,3266
2,KECAMATAN,6248,BANDAR DUA,3590,4847,8437
2,KECAMATAN,6294,MEURAH DUA,2344,2740,5084
2,KECAMATAN,6314,BANDAR BARU,6010,6710,12720
2,KECAMATAN,6358,PANTERAJA,1521,1300,2821
2,KECAMATAN,6369,TRIENGGADENG,3869,4105,7974
1,KABUPATEN/KOTA,6397,KOTA BANDA ACEH,24082,30338,54420
2,KECAMATAN,6398,BAITURRAHMAN,6679,5261,11940
2,KECAMATAN,6409,KUTA ALAM,8282,6568,14850
2,KECAMATAN,6421,MEURAXA,3215,3080,6295
2,KECAMATAN,6438,SYIAH KUALA,6280,4618,10898
2,KECAMATAN,6449,LUENG BATA,4387,3644,8031
2,KECAMATAN,6459,KUTA RAJA,1716,1702,3418
2,KECAMATAN,6466,BANDA RAYA,5642,3709,9351
2,KECAMATAN,6477,JAYA BARU,4594,3471,8065
2,KECAMATAN,6487,ULEE KARENG,5028,3950,8978
1,KABUPATEN/KOTA,6497,KOTA SABANG,45823,36003,81826
2,KECAMATAN,6498,SUKAKARYA,3555,2918,6473
2,KECAMATAN,6507,SUKAJAYA,3746,2619,6365
1,KABUPATEN/KOTA,6518,KOTA LHOKSEUMAWE,7301,5537,12838
2,KECAMATAN,6519,MUARA DUA,9299,4709,14008
2,KECAMATAN,6537,BANDA SAKTI,14892,8317,23209
2,KECAMATAN,6556,BLANG MANGAT,4426,3013,7439
2,KECAMATAN,6579,MUARA SATU,5999,3257,9256
1,KABUPATEN/KOTA,6591,KOTA LANGSA,34616,19296,53912
2,KECAMATAN,6592,LANGSA TIMUR,3639,1838,5477
2,KECAMATAN,6607,LANGSA BARAT,6976,3235,10211
2,KECAMATAN,6617,LANGSA KOTA,8533,4667,13200
2,KECAMATAN,6628,LANGSA LAMA,9313,3508,12821
2,KECAMATAN,6638,LANGSA BARO,14232,5092,19324
1,KABUPATEN/KOTA,6648,KOTA SUBULUSSALAM,42693,18340,61033
2,KECAMATAN,6649,SIMPANG KIRI,7966,4310,12276
2,KECAMATAN,6664,PENANGGALAN,3299,2038,5337
2,KECAMATAN,6675,RUNDENG,3764,1685,5449
2,KECAMATAN,6699,SULTAN DAULAT,3649,2204,5853
2,KECAMATAN,6717,LONGKIB,1494,1039,2533
0,PROVINSI,6728,SUMATERA UTARA,0,0,0
1,KABUPATEN/KOTA,7240,TAPANULI TENGAH,20172,11276,31448
2,KECAMATAN,7241,BARUS,3972,2833,6805
2,KECAMATAN,7361,ANDAM DEWI,1407,4863,6270
2,KECAMATAN,7376,SITAHUIS,0,0,0
2,KECAMATAN,7383,TUKKA,1587,3496,5083
2,KECAMATAN,7392,BADIRI,2631,6471,9102
2,KECAMATAN,7402,PASARIBU TOBING,0,0,0
2,KECAMATAN,7411,BARUS UTARA,0,0,0
2,KECAMATAN,7418,SUKA BANGUN,340,1114,1454
2,KECAMATAN,7425,LUMUT,0,0,0
2,KECAMATAN,7352,SIRANDORUNG,1010,4761,5771
2,KECAMATAN,7340,SORKAM BARAT,2183,4574,6757
2,KECAMATAN,7255,SORKAM,0,0,0
2,KECAMATAN,7271,PANDAN,0,0,0
2,KECAMATAN,7281,PINANGSORI,2315,6550,8865
2,KECAMATAN,7289,MANDUAMAS,1828,5877,7705
2,KECAMATAN,7299,KOLANG,1291,6367,7658
2,KECAMATAN,7312,TAPIAN NAULI,2000,6211,8211
2,KECAMATAN,7322,SIBABANGUN,2050,5479,7529
2,KECAMATAN,7330,SOSOR GADONG,0,0,0
2,KECAMATAN,7432,SARUDIK,0,0,0
1,KABUPATEN/KOTA,7438,TAPANULI UTARA,22614,58596,81210
2,KECAMATAN,7439,TARUTUNG,2140,16837,18977
2,KECAMATAN,7668,GAROGA,914,6395,7309
2,KECAMATAN,7645,PANGARIBUAN,929,11370,12299
2,KECAMATAN,7621,SIPAHUTAR,706,10962,11668
2,KECAMATAN,7606,PARMONANGAN,303,6447,6750
2,KECAMATAN,7591,PAGARAN,308,7648,7956
2,KECAMATAN,7557,PURBA TUA,482,2920,3402
2,KECAMATAN,7548,SIMANGUMBAN,677,2716,3393
2,KECAMATAN,7534,PAHAE JAE,821,4304,5125
2,KECAMATAN,7514,PAHAE JULU,586,5306,5892
2,KECAMATAN,7499,SIPOHOLON,936,9178,10114
2,KECAMATAN,7484,ADIAN KOTING,518,5878,6396
2,KECAMATAN,7471,SIATAS BARITA,664,5661,6325
2,KECAMATAN,7681,MUARA,229,6506,6735
1,KABUPATEN/KOTA,7697,TAPANULI SELATAN,10213,102128,112341
2,KECAMATAN,7698,ANGKOLA BARAT,8823,2362,11185
2,KECAMATAN,7931,TANO TOMBANGAN ANGKOLA,1431,6247,7678
2,KECAMATAN,7921,MUARA BATANG TORU,2141,2946,5087
2,KECAMATAN,7908,AEK BILAH,2908,975,3883
2,KECAMATAN,7888,SAYUR MATINGGI,7994,3401,11395
2,KECAMATAN,7875,MARANCAR,3491,1451,4942
2,KECAMATAN,7864,ARSE,2975,1570,4545
2,KECAMATAN,7827,BATANG ANGKOLA,11997,3672,15669
2,KECAMATAN,7809,ANGKOLA SELATAN,5712,6129,11841
2,KECAMATAN,7794,SAIPAR DOLOK HOLE,4687,2178,6865
2,KECAMATAN,7753,SIPIROK,11369,4333,15702
2,KECAMATAN,7737,ANGKOLA TIMUR,8052,1963,10015
2,KECAMATAN,7713,BATANG TORU,7160,7530,14690
2,KECAMATAN,7949,ANGKOLA SANGKUNUR,3871,5876,9747
1,KABUPATEN/KOTA,7960,NIAS,82611,50633,133244
2,KECAMATAN,7961,HILIDUHO,222,4117,4339
2,KECAMATAN,8082,ULUGAWO,486,4785,5271
2,KECAMATAN,8069,BOTOMUZOI,387,3819,4206
2,KECAMATAN,8056,HILISERANGKAI,427,5891,6318
2,KECAMATAN,8020,BAWOLATO,1524,7707,9231
2,KECAMATAN,8001,IDANO GAWO,2099,9244,11343
2,KECAMATAN,7975,GIDO,517,8501,9018
1,KABUPATEN/KOTA,8094,LANGKAT,5662,44064,49726
2,KECAMATAN,8095,BAHOROK,0,0,0
2,KECAMATAN,8302,BABALAN,12053,12274,24327
2,KECAMATAN,8311,PANGKALAN SUSU,0,0,0
2,KECAMATAN,8323,BESITANG,0,0,0
2,KECAMATAN,8334,SEI LEPAN,9688,12619,22307
2,KECAMATAN,8350,BRANDAN BARAT,0,0,0
2,KECAMATAN,8358,BATANG SERANGAN,0,0,0
2,KECAMATAN,8368,SAWIT SEBERANG,5258,7260,12518
2,KECAMATAN,8376,SIRAPIT,4312,4443,8755
2,KECAMATAN,8387,KUTAMBARU,2173,4877,7050
2,KECAMATAN,8289,GEBANG,10299,9860,20159
2,KECAMATAN,8274,PADANG TUALANG,11242,12489,23731
2,KECAMATAN,8254,TANJUNG PURA,0,0,0
2,KECAMATAN,8115,SALAPIAN,5536,8311,13847
2,KECAMATAN,8133,KUALA,11025,9508,20533
2,KECAMATAN,8151,SEI BINGEI,8473,14775,23248
2,KECAMATAN,8168,BINJAI,13548,8475,22023
2,KECAMATAN,8176,SELESAI,0,0,0
2,KECAMATAN,8191,STABAT,0,0,0
2,KECAMATAN,8204,WAMPU,11793,9067,20860
2,KECAMATAN,8220,SECANGGANG,17900,14641,32541
2,KECAMATAN,8240,HINAI,0,0,0
2,KECAMATAN,8398,PEMATANG JAYA,0,0,0
1,KABUPATEN/KOTA,8408,KARO,123300,128599,251899
2,KECAMATAN,8409,KABANJAHE,5367,21660,27027
2,KECAMATAN,8655,NAMAN TERAN,986,4123,5109
2,KECAMATAN,8645,MERDEKA,1105,5109,6214
2,KECAMATAN,8637,DOLAT RAYAT,483,3606,4089
2,KECAMATAN,8620,KUTABULUH,1330,5130,6460
2,KECAMATAN,8602,SIMPANG EMPAT,1356,8141,9497
2,KECAMATAN,8593,PAYUNG,667,4816,5483
2,KECAMATAN,8580,MARDINGDING,735,7003,7738
2,KECAMATAN,8564,LAUBALENG,929,7498,8427
2,KECAMATAN,8544,TIGABINANGA,1594,8804,10398
2,KECAMATAN,8519,JUHAR,651,6993,7644
2,KECAMATAN,8496,MUNTE,1389,8829,10218
2,KECAMATAN,8476,MEREK,854,8271,9125
2,KECAMATAN,8453,TIGAPANAH,1593,13036,14629
2,KECAMATAN,8433,BARUSJAHE,1115,10680,11795
2,KECAMATAN,8423,BERASTAGI,4211,14167,18378
2,KECAMATAN,8670,TIGANDERKET,1097,5880,6977
1,KABUPATEN/KOTA,8688,DELI SERDANG,25462,143746,169208
2,KECAMATAN,8689,GUNUNG MERIAH,0,0,0
2,KECAMATAN,8966,DELI TUA,0,0,0
2,KECAMATAN,8973,SUNGGAL,0,0,0
2,KECAMATAN,8991,HAMPARAN PERAK,44699,23338,68037
2,KECAMATAN,9012,LABUHAN DELI,0,0,0
2,KECAMATAN,9018,PERCUT SEI TUAN,91428,62678,154106
2,KECAMATAN,9039,BATANG KUIS,16245,8625,24870
2,KECAMATAN,9051,LUBUK PAKAM,0,0,0
2,KECAMATAN,9065,PAGAR MERBAU,0,0,0
2,KECAMATAN,9082,PANTAI LABU,10445,8143,18588
2,KECAMATAN,8957,PATUMBAK,0,0,0
2,KECAMATAN,8936,STM HULU,1225,5003,6228
2,KECAMATAN,8702,TANJUNG MORAWA,0,0,0
2,KECAMATAN,8729,SIBOLANGIT,0,0,0
2,KECAMATAN,8760,KUTALIMBARU,0,0,0
2,KECAMATAN,8775,PANCUR BATU,14120,24919,39039
2,KECAMATAN,8801,NAMORAMBE,0,0,0
2,KECAMATAN,8856,STM HILIR,0,0,0
2,KECAMATAN,8872,BANGUN PURBA,4991,6222,11213
2,KECAMATAN,8906,GALANG,0,0,0
2,KECAMATAN,9102,BERINGIN,0,0,0
1,KABUPATEN/KOTA,9114,SIMALUNGUN,183153,138928,322081
2,KECAMATAN,9115,SIANTAR,12917,19726,32643
2,KECAMATAN,9326,HUTA BAYU RAJA,3696,10975,14671
2,KECAMATAN,9340,JAWA MARAJA BAH JAMBI,4883,5400,10283
2,KECAMATAN,9349,DOLOK PARDAMEAN,515,7822,8337
2,KECAMATAN,9360,PEMATANG BANDAR,6474,9134,15608
2,KECAMATAN,9372,BANDAR HULUAN,6467,6922,13389
2,KECAMATAN,9382,BANDAR,13056,16782,29838
2,KECAMATAN,9397,BANDAR MASILAM,6559,5814,12373
2,KECAMATAN,9407,SILIMAKUTA,626,5254,5880
2,KECAMATAN,9414,DOLOK SILAU,850,6301,7151
2,KECAMATAN,9424,SILOU KAHEAN,2095,6009,8104
2,KECAMATAN,9441,TAPIAN DOLOK,9783,10642,20425
2,KECAMATAN,9452,RAYA,2199,13824,16023
2,KECAMATAN,9470,UJUNG PADANG,8424,11708,20132
2,KECAMATAN,9310,DOLOK BATU NANGGAR,11047,10255,21302
2,KECAMATAN,9304,GIRSANG SIPANGAN BOLON,860,7009,7869
2,KECAMATAN,9298,HARANGGAOL HORISON,222,2690,2912
2,KECAMATAN,9133,GUNUNG MALELA,8780,9304,18084
2,KECAMATAN,9150,GUNUNG MALIGAS,7665,5511,13176
2,KECAMATAN,9160,PANEI,2220,9457,11677
2,KECAMATAN,9172,PANOMBEIAN PANE,3068,7582,10650
2,KECAMATAN,9182,JORLANG HATARAN,1949,6265,8214
2,KECAMATAN,9192,RAYA KAHEAN,2269,6713,8982
2,KECAMATAN,9204,BOSAR MALIGAS,8701,11264,19965
2,KECAMATAN,9220,SIDAMANIK,3902,10164,14066
2,KECAMATAN,9234,PEMATANG SIDAMANIK,1896,6648,8544
2,KECAMATAN,9245,TANAH JAWA,8933,16027,24960
2,KECAMATAN,9266,HATONDUHAN,2079,8167,10246
2,KECAMATAN,9276,DOLOK PANRIBUAN,865,8446,9311
2,KECAMATAN,9287,PURBA,1039,9521,10560
2,KECAMATAN,9488,PAMATANG SILIMA HUTA,323,5053,5376
1,KABUPATEN/KOTA,9497,ASAHAN,144362,276389,420751
2,KECAMATAN,9498,MERANTI,3218,6662,9880
2,KECAMATAN,9641,RAHUNING,4415,4765,9180
2,KECAMATAN,9649,SEI DADAP,7438,7839,15277
2,KECAMATAN,9660,SEI KEPAYANG BARAT,2862,2225,5087
2,KECAMATAN,9667,SEI KEPAYANG TIMUR,2391,1179,3570
2,KECAMATAN,9673,TINGGI RAJA,4582,5487,10069
2,KECAMATAN,9681,SETIA JANJI,2826,3921,6747
2,KECAMATAN,9687,SILAU LAUT,4445,5187,9632
2,KECAMATAN,9693,RAWANG PANCA ARGA,4490,4739,9229
2,KECAMATAN,9701,PULO BANDRING,7239,8182,15421
2,KECAMATAN,9712,TELUK DALAM,4211,4397,8608
2,KECAMATAN,9631,AEK SONGSONGAN,3259,5662,8921
2,KECAMATAN,9618,KOTA KISARAN TIMUR,20541,14396,34937
2,KECAMATAN,9604,KOTA KISARAN BARAT,16480,12068,28548
2,KECAMATAN,9506,AIR JOMAN,9421,11402,20823
2,KECAMATAN,9514,TANJUNG BALAI,7629,5422,13051
2,KECAMATAN,9523,SEI KEPAYANG,2956,4231,7187
2,KECAMATAN,9530,SIMPANG EMPAT,7103,10817,17920
2,KECAMATAN,9539,AIR BATU,9790,9766,19556
2,KECAMATAN,9552,PULAU RAKYAT,6746,9180,15926
2,KECAMATAN,9565,BANDAR PULAU,4477,6895,11372
2,KECAMATAN,9576,BUNTU PANE,4976,7425,12401
2,KECAMATAN,9586,BANDAR PASIR MANDOGE,4857,11593,16450
2,KECAMATAN,9596,AEK KUASAN,4761,7872,12633
2,KECAMATAN,9719,AEK LEDONG,3824,6019,9843
1,KABUPATEN/KOTA,9727,LABUHANBATU,154937,177331,332268
2,KECAMATAN,9728,RANTAU UTARA,24400,16271,40671
2,KECAMATAN,9739,RANTAU SELATAN,19295,9890,29185
2,KECAMATAN,9749,BILAH BARAT,10276,6125,16401
2,KECAMATAN,9760,BILAH HILIR,10740,13104,23844
2,KECAMATAN,9774,BILAH HULU,15414,13143,28557
2,KECAMATAN,9799,PANGKATAN,7165,9523,16688
2,KECAMATAN,9807,PANAI TENGAH,5368,8405,13773
2,KECAMATAN,9818,PANAI HILIR,6461,7671,14132
2,KECAMATAN,9827,PANAI HULU,7452,7769,15221
1,KABUPATEN/KOTA,9835,DAIRI,106571,91901,198472
2,KECAMATAN,9836,SIDIKALANG,5185,17072,22257
2,KECAMATAN,10009,SILAHISABUNGAN,200,2090,2290
2,KECAMATAN,10003,BRAMPU,1314,2208,3522
2,KECAMATAN,9994,GUNUNG SITEMBER,804,3933,4737
2,KECAMATAN,9984,LAE PARIRA,1210,5601,6811
2,KECAMATAN,9972,PARBULUAN,805,8640,9445
2,KECAMATAN,9958,PEGAGAN HILIR,905,6282,7187
2,KECAMATAN,9947,SIEMPAT NEMPU HILIR,730,4521,5251
2,KECAMATAN,9934,SIEMPAT NEMPU HULU,2251,6313,8564
2,KECAMATAN,9914,TANAH PINEM,1809,9164,10973
2,KECAMATAN,9897,SILIMA PUNGGA PUNGA,1240,5235,6475
2,KECAMATAN,9883,SIEMPAT NEMPU,1109,7533,8642
2,KECAMATAN,9868,TIGALINGGA,1728,9860,11588
2,KECAMATAN,9848,SUMBUL,1797,16966,18763
2,KECAMATAN,10015,SITINJO,1038,4314,5352
1,KABUPATEN/KOTA,10020,TOBA SAMOSIR,22125,109732,131857
2,KECAMATAN,10021,BALIGE,1692,16619,18311
2,KECAMATAN,83408,BONATUA LUNASI,279,2402,2681
2,KECAMATAN,10213,SIANTAR NARUMONDA,300,2563,2863
2,KECAMATAN,10206,TAMPAHAN,134,1971,2105
2,KECAMATAN,10200,NASSAU,617,3259,3876
2,KECAMATAN,10191,SIGUMPAR,269,3368,3637
2,KECAMATAN,10173,ULUAN,297,3850,4147
2,KECAMATAN,10157,LUMBAN JULU,242,3990,4232
2,KECAMATAN,10147,AJIBATA,191,3686,3877
2,KECAMATAN,10120,PORSEA,758,5734,6492
2,KECAMATAN,10113,BORBOR,208,3139,3347
2,KECAMATAN,10102,PINTU POHAN MERANTI,574,2485,3059
2,KECAMATAN,10091,HABINSARAN,636,6951,7587
2,KECAMATAN,10076,SILAEN,414,6305,6719
2,KECAMATAN,10055,LAGUBOTI,781,9000,9781
2,KECAMATAN,83409,PARMAKSIAN,762,4203,4965
1,KABUPATEN/KOTA,10227,MANDAILING NATAL,8154,79525,87679
2,KECAMATAN,10228,PANYABUNGAN KOTA,29000,5814,34814
2,KECAMATAN,10485,LINGGA BAYU,6986,4178,11164
2,KECAMATAN,10505,BATAHAN,7227,2751,9978
2,KECAMATAN,10524,NATAL,8616,5370,13986
2,KECAMATAN,10554,MUARA BATANG GADIS,4479,2393,6872
2,KECAMATAN,10569,RANTO BAEK,4376,1664,6040
2,KECAMATAN,10588,HUTA BARGOT,3140,626,3766
2,KECAMATAN,10602,PUNCAK SORIK MARAPI,3985,299,4284
2,KECAMATAN,10614,PAKANTAN,725,370,1095
2,KECAMATAN,10623,SINUNUKAN,4297,4290,8587
2,KECAMATAN,10453,BATANG NATAL,9102,2683,11785
2,KECAMATAN,10437,MUARA SIPONGI,3410,1666,5076
2,KECAMATAN,10423,ULU PUNGKUT,2232,182,2414
2,KECAMATAN,10267,PANYABUNGAN UTARA,6169,2550,8719
2,KECAMATAN,10280,PANYABUNGAN TIMUR,5181,805,5986
2,KECAMATAN,10296,PANYABUNGAN SELATAN,4475,656,5131
2,KECAMATAN,10308,PANYABUNGAN BARAT,4153,683,4836
2,KECAMATAN,10319,SIABU,16900,4237,21137
2,KECAMATAN,10343,BUKIT MALINTANG,3906,1343,5249
2,KECAMATAN,10355,KOTANOPAN,10802,1950,12752
2,KECAMATAN,10392,LEMBAH SORIK MARAPI,4566,637,5203
2,KECAMATAN,10402,TAMBANGAN,5476,837,6313
2,KECAMATAN,10638,NAGA JUANG,845,1062,1907
1,KABUPATEN/KOTA,10646,NIAS SELATAN,150048,47046,197094
2,KECAMATAN,10647,LOLOMATUA,0,0,0
2,KECAMATAN,11005,FANAYAMA,0,0,0
2,KECAMATAN,83459,ULUNOYO,0,0,0
2,KECAMATAN,83460,HURUNA,0,0,0
2,KECAMATAN,83462,ONOHAZUMBA,0,0,0
2,KECAMATAN,83464,ULUSUSUA,1720,5107,6827
2,KECAMATAN,83466,SOMAMBAWA,529,4392,4921
2,KECAMATAN,83467,BORONADU,0,0,0
2,KECAMATAN,83468,SIMUK,0,0,0
2,KECAMATAN,10990,MAZO,851,6331,7182
2,KECAMATAN,10963,ARAMO,0,0,0
2,KECAMATAN,10674,GOMO,0,0,0
2,KECAMATAN,10699,LAHUSA,952,10935,11887
2,KECAMATAN,10735,HIBALA,0,0,0
2,KECAMATAN,10805,TELUK DALAM,1587,16952,18539
2,KECAMATAN,10823,AMANDRAYA,1376,3881,5257
2,KECAMATAN,10887,SUSUA,0,0,0
2,KECAMATAN,10902,MANIAMOLO,0,0,0
2,KECAMATAN,10917,HILIMEGAI,0,0,0
2,KECAMATAN,10929,TOMA,0,0,0
2,KECAMATAN,10941,MAZINO,1391,5820,7211
2,KECAMATAN,10953,UMBUNASI,0,0,0
2,KECAMATAN,83471,TANAH MASA,0,0,0
1,KABUPATEN/KOTA,11022,PAKPAK BHARAT,8406,53418,61824
2,KECAMATAN,11023,SITELU TALI URANG JEHE,2143,1729,3872
2,KECAMATAN,11034,KERAJAAN,1262,2414,3676
2,KECAMATAN,11045,SALAK,855,2621,3476
2,KECAMATAN,11052,SITELU TALI URANG JULU,599,1122,1721
2,KECAMATAN,11058,PERGETTENG GETTENG SENGKUT,780,971,1751
2,KECAMATAN,11064,PAGINDAR,207,346,553
2,KECAMATAN,11069,TINADA,421,1386,1807
2,KECAMATAN,11076,SIEMPAT RUBE,414,1486,1900
1,KABUPATEN/KOTA,11083,HUMBANG HASUNDUTAN,6681,12075,18756
2,KECAMATAN,11084,PARLILITAN,0,0,0
2,KECAMATAN,11216,PAKKAT,0,0,0
2,KECAMATAN,11203,ONAN GANJANG,496,4531,5027
2,KECAMATAN,11192,SIJAMAPOLANG,306,2260,2566
2,KECAMATAN,11162,DOLOK SANGGUL,0,0,0
2,KECAMATAN,11139,LINTONG NIHUTA,1419,13138,14557
2,KECAMATAN,11127,PARANGINAN,0,0,0
2,KECAMATAN,11119,BAKTIRAJA,208,3339,3547
2,KECAMATAN,11105,POLLUNG,0,0,0
2,KECAMATAN,11237,TARABINTANG,0,0,0
1,KABUPATEN/KOTA,11247,SAMOSIR,2429,23268,25697
2,KECAMATAN,11248,SIANJUR MULA MULA,215,4468,4683
2,KECAMATAN,11260,HARIAN,363,3524,3887
2,KECAMATAN,11279,ONAN RUNGGU,261,4752,5013
2,KECAMATAN,11292,NAINGGOLAN,297,5292,5589
2,KECAMATAN,11305,PALIPI,358,7874,8232
2,KECAMATAN,11319,RONGGUR NIHUTA,267,3605,3872
2,KECAMATAN,11328,PANGURURAN,966,13704,14670
2,KECAMATAN,11357,SIMANINDO,479,10367,10846
1,KABUPATEN/KOTA,11374,SERDANG BEDAGAI,3206,53586,56792
2,KECAMATAN,11375,PANTAI CERMIN,11276,9103,20379
2,KECAMATAN,11604,TEBING SYAHBANDAR,10468,5890,16358
2,KECAMATAN,11593,SEI BAMBAN,7063,13952,21015
2,KECAMATAN,11579,PEGAJAHAN,5846,8612,14458
2,KECAMATAN,11564,TEBING TINGGI,12524,9286,21810
2,KECAMATAN,11553,SERBA JADI,4518,5707,10225
2,KECAMATAN,11543,SILINDA,1158,3375,4533
2,KECAMATAN,11531,KOTARIH,1591,2761,4352
2,KECAMATAN,11502,DOLOK MASIHUL,13599,12301,25900
2,KECAMATAN,11481,SIPISPIS,7929,8827,16756
2,KECAMATAN,11463,DOLOK MERAWAN,5940,3684,9624
2,KECAMATAN,11457,BANDAR KHALIFAH,4193,7930,12123
2,KECAMATAN,11448,TANJUNG BERINGIN,7955,7942,15897
2,KECAMATAN,11417,TELUK MENGKUDU,9692,9765,19457
2,KECAMATAN,11388,PERBAUNGAN,28203,21630,49833
2,KECAMATAN,11615,BINTANG BAYU,3783,2781,6564
1,KABUPATEN/KOTA,11635,BATU BARA,135738,133546,269284
2,KECAMATAN,11636,MEDANG DERAS,10611,10600,21211
2,KECAMATAN,11651,SEI SUKA,13961,12921,26882
2,KECAMATAN,11665,AIR PUTIH,11257,12959,24216
2,KECAMATAN,11679,LIMA PULUH,0,0,0
2,KECAMATAN,11707,TALAWI,0,0,0
2,KECAMATAN,11721,TANJUNG TIRAM,0,0,0
2,KECAMATAN,11734,SEI BALAI,6451,7252,13703
1,KABUPATEN/KOTA,12208,PADANG LAWAS UTARA,42280,43732,86012
2,KECAMATAN,12209,DOLOK SIGOMPULON,5245,2407,7652
2,KECAMATAN,12254,DOLOK,9196,2746,11942
2,KECAMATAN,12341,HALONGONAN,10677,5694,16371
2,KECAMATAN,12386,PADANG BOLAK,24707,6380,31087
2,KECAMATAN,12464,PADANG BOLAK JULU,3887,1054,4941
2,KECAMATAN,12488,PORTIBI,10348,1955,12303
2,KECAMATAN,12527,BATANG ONANG,4184,1640,5824
2,KECAMATAN,12560,SIMANGAMBAT,12475,13490,25965
2,KECAMATAN,12595,HULU SIHAPAS,1693,382,2075
1,KABUPATEN/KOTA,12606,PADANG LAWAS,82412,35748,118160
2,KECAMATAN,12607,SOSOPAN,3501,1262,4763
2,KECAMATAN,83407,AEK NABARA BARUMUN,4731,939,5670
2,KECAMATAN,83406,BARUMUN SELATAN,2990,710,3700
2,KECAMATAN,12891,BATANG LUBU SUTAM,4142,1598,5740
2,KECAMATAN,12851,SOSA,10863,3981,14844
2,KECAMATAN,12809,BARUMUN,15495,4218,19713
2,KECAMATAN,12793,ULU BARUMUN,4212,1738,5950
2,KECAMATAN,12761,HUTA RAJA TINGGI,10019,8416,18435
2,KECAMATAN,12736,LUBUK BARUMUN,6099,1660,7759
2,KECAMATAN,12708,HURISTAK,5480,2539,8019
2,KECAMATAN,12630,BARUMUN TENGAH,0,0,0
2,KECAMATAN,83472,SIHAPAS BARUMUN,0,0,0
1,KABUPATEN/KOTA,6729,LABUHANBATU SELATAN,67532,27061,94593
2,KECAMATAN,6730,KOTAPINANG,14894,13122,28016
2,KECAMATAN,6741,KAMPUNG RAKYAT,12712,14141,26853
2,KECAMATAN,6757,TORGAMBA,17524,29511,47035
2,KECAMATAN,6772,SUNGAI KANAN,14780,7798,22578
2,KECAMATAN,6782,SILANGKITANG,6988,9008,15996
1,KABUPATEN/KOTA,6789,LABUHANBATU UTARA,66898,73580,140478
2,KECAMATAN,6790,KUALUH HULU,11924,21298,33222
2,KECAMATAN,6804,KUALUH LEIDONG,5008,8122,13130
2,KECAMATAN,6812,KUALUH HILIR,4649,9288,13937
2,KECAMATAN,6820,AEK KUO,5583,9640,15223
2,KECAMATAN,6829,MARBAU,11432,9894,21326
2,KECAMATAN,6862,AEK NATAS,7817,7835,15652
2,KECAMATAN,6875,KUALUH SELATAN,11146,18706,29852
1,KABUPATEN/KOTA,6888,NIAS UTARA,57559,84783,142342
2,KECAMATAN,6889,LOTU,508,4498,5006
2,KECAMATAN,6983,LAHEWA,1884,6709,8593
2,KECAMATAN,6973,AFULU,1024,3083,4107
2,KECAMATAN,6964,TUGALA OYO,202,2890,3092
2,KECAMATAN,6949,ALASA,964,5926,6890
2,KECAMATAN,6942,ALASA TALUMUZOI,303,2070,2373
2,KECAMATAN,6930,NAMOHALU ESIWA,346,4987,5333
2,KECAMATAN,6923,SITOLU ORI,523,4696,5219
2,KECAMATAN,6914,TUHEMBERUA,469,4122,4591
2,KECAMATAN,6903,SAWO,639,3293,3932
2,KECAMATAN,7005,LAHEWA TIMUR,421,3031,3452
1,KABUPATEN/KOTA,7013,NIAS BARAT,7283,45305,52588
2,KECAMATAN,7014,LAHOMI,616,4002,4618
2,KECAMATAN,7026,SIROMBU,1121,3396,4517
2,KECAMATAN,7052,MANDREHE BARAT,243,2714,2957
2,KECAMATAN,7078,MANDREHE,700,8860,9560
2,KECAMATAN,7099,MANDREHE UTARA,406,3086,3492
2,KECAMATAN,7112,LOLOFITU MOI,1197,4315,5512
1,KABUPATEN/KOTA,11743,KOTA MEDAN,4283,26373,30656
2,KECAMATAN,11744,MEDAN KOTA,0,0,0
2,KECAMATAN,11844,MEDAN LABUHAN,0,0,0
2,KECAMATAN,11851,MEDAN TEMBUNG,0,0,0
2,KECAMATAN,11859,MEDAN MAIMUN,12801,9913,22714
2,KECAMATAN,11866,MEDAN POLONIA,0,0,0
2,KECAMATAN,11872,MEDAN BARU,0,0,0
2,KECAMATAN,11879,MEDAN PERJUANGAN,0,0,0
2,KECAMATAN,11889,MEDAN PETISAH,0,0,0
2,KECAMATAN,11897,MEDAN TIMUR,28108,28932,57040
2,KECAMATAN,11838,MEDAN MARELAN,0,0,0
2,KECAMATAN,11831,MEDAN JOHOR,0,0,0
2,KECAMATAN,11818,MEDAN AREA,0,0,0
2,KECAMATAN,11757,MEDAN SUNGGAL,27470,24877,52347
2,KECAMATAN,11764,MEDAN HELVETIA,0,0,0
2,KECAMATAN,11772,MEDAN DENAI,0,0,0
2,KECAMATAN,11779,MEDAN BARAT,19269,20754,40023
2,KECAMATAN,11786,MEDAN DELI,0,0,0
2,KECAMATAN,11793,MEDAN TUNTUNGAN,0,0,0
2,KECAMATAN,11803,MEDAN BELAWAN,0,0,0
2,KECAMATAN,11810,MEDAN AMPLAS,0,0,0
2,KECAMATAN,11909,MEDAN SELAYANG,0,0,0
1,KABUPATEN/KOTA,11916,KOTA PEMATANGSIANTAR,87648,84476,172124
2,KECAMATAN,11917,SIANTAR TIMUR,4159,14493,18652
2,KECAMATAN,11925,SIANTAR BARAT,10327,9058,19385
2,KECAMATAN,11934,SIANTAR UTARA,7902,15791,23693
2,KECAMATAN,11942,SIANTAR SELATAN,1181,8265,9446
2,KECAMATAN,11949,SIANTAR MARIHAT,1689,8070,9759
2,KECAMATAN,11957,SIANTAR MARTOBA,7585,12545,20130
2,KECAMATAN,11965,SIANTAR SITALASARI,5997,7923,13920
2,KECAMATAN,11971,SIANTAR MARIMBUN,1284,7142,8426
1,KABUPATEN/KOTA,11978,KOTA SIBOLGA,40124,83287,123411
2,KECAMATAN,11979,SIBOLGA UTARA,1651,7978,9629
2,KECAMATAN,11985,SIBOLGA KOTA,3161,3866,7027
2,KECAMATAN,11990,SIBOLGA SELATAN,5701,6600,12301
2,KECAMATAN,11995,SIBOLGA SAMBAS,4169,4129,8298
1,KABUPATEN/KOTA,12000,KOTA TANJUNG BALAI,14682,22573,37255
2,KECAMATAN,12001,TANJUNG BALAI SELATAN,3993,5131,9124
2,KECAMATAN,12008,TANJUNG BALAI UTARA,3523,3551,7074
2,KECAMATAN,12014,SEI TUALANG RASO,5044,3642,8686
2,KECAMATAN,12020,TELUK NIBUNG,7963,5189,13152
2,KECAMATAN,12026,DATUK BANDAR,6436,6972,13408
2,KECAMATAN,12032,DATUK BANDAR TIMUR,7560,4126,11686
1,KABUPATEN/KOTA,12038,KOTA BINJAI,34519,28611,63130
2,KECAMATAN,12039,BINJAI UTARA,23149,11275,34424
2,KECAMATAN,12049,BINJAI KOTA,8407,7482,15889
2,KECAMATAN,12057,BINJAI BARAT,12530,7522,20052
2,KECAMATAN,12064,BINJAI TIMUR,17748,10030,27778
2,KECAMATAN,12072,BINJAI SELATAN,16054,9154,25208
1,KABUPATEN/KOTA,12081,KOTA TEBING TINGGI,77888,45463,123351
2,KECAMATAN,12082,PADANG HULU,8165,6273,14438
2,KECAMATAN,12090,RAMBUTAN,9399,7137,16536
2,KECAMATAN,12098,PADANG HILIR,9204,6888,16092
2,KECAMATAN,12106,BAJENIS,8963,7862,16825
2,KECAMATAN,12114,TEBING TINGGI KOTA,5861,7338,13199
1,KABUPATEN/KOTA,12122,KOTA PADANG SIDIMPUAN,41592,35498,77090
2,KECAMATAN,12123,PADANGSIDIMPUAN UTARA,24148,5833,29981
2,KECAMATAN,12140,PADANGSIDIMPUAN SELATAN,20957,8884,29841
2,KECAMATAN,12153,PADANGSIDIMPUAN BATUNADUA,7548,2276,9824
2,KECAMATAN,12169,PADANGSIDIMPUAN HUTAIMBARU,6595,1554,8149
2,KECAMATAN,12180,PADANGSIDIMPUAN TENGGARA,9769,3925,13694
2,KECAMATAN,12199,PADANGSIDIMPUAN ANGKOLA JULU,2830,951,3781
1,KABUPATEN/KOTA,7132,KOTA GUNUNGSITOLI,71847,23423,95270
2,KECAMATAN,7133,GUNUNGSITOLI,6030,20577,26607
2,KECAMATAN,7166,GUNUNGSITOLI SELATAN,535,6019,6554
2,KECAMATAN,7182,GUNUNGSITOLI UTARA,1333,6073,7406
2,KECAMATAN,7193,GUNUNGSITOLI IDANOI,1153,9868,11021
2,KECAMATAN,7230,GUNUNGSITOLI BARAT,313,3331,3644
0,PROVINSI,12920,SUMATERA BARAT,0,0,0
1,KABUPATEN/KOTA,12921,PESISIR SELATAN,9364,45868,55232
2,KECAMATAN,12922,PANCUNG SOAL,6917,3211,10128
2,KECAMATAN,83474,RANAH AMPEK HULU TAPAN,4143,1864,6007
2,KECAMATAN,83473,AIRPURA,3805,2483,6288
2,KECAMATAN,13005,IV NAGARI BAYANG UTARA,3711,549,4260
2,KECAMATAN,12996,BASA AMPEK BALAI TAPAN,3384,2180,5564
2,KECAMATAN,12990,LUNANG,4741,5076,9817
2,KECAMATAN,12982,LINGGO SARI BAGANTI,13824,5574,19398
2,KECAMATAN,12977,SUTERA,16484,4997,21481
2,KECAMATAN,12964,KOTO XI TARUSAN,16477,5388,21865
2,KECAMATAN,12959,BAYANG,16018,3220,19238
2,KECAMATAN,12952,IV JURAI,17408,5299,22707
2,KECAMATAN,12946,BATANG KAPAS,9918,3763,13681
2,KECAMATAN,12936,LENGAYANG,16625,7014,23639
2,KECAMATAN,12931,RANAH PESISIR,9987,4188,14175
2,KECAMATAN,83475,SILAUT,3708,3568,7276
1,KABUPATEN/KOTA,13010,SOLOK,147150,58374,205524
2,KECAMATAN,13011,PANTAI CERMIN,7142,1409,8551
2,KECAMATAN,13090,TIGO LURAH,3878,910,4788
2,KECAMATAN,13086,HILIRAN GUMANTI,6056,1149,7205
2,KECAMATAN,13083,JUNJUNG SIRI,5220,738,5958
2,KECAMATAN,13073,X KOTO DIATAS,7811,1579,9390
2,KECAMATAN,13064,X KOTO SINGKARAK,13797,2730,16527
2,KECAMATAN,13055,KUBUNG,23290,3836,27126
2,KECAMATAN,13045,IX KOTO SEI LASI,4366,911,5277
2,KECAMATAN,13039,BUKIT SUNDI,9553,1730,11283
2,KECAMATAN,13030,GUNUNG TALANG,19944,3412,23356
2,KECAMATAN,13023,LEMBANG JAYA,10038,1668,11706
2,KECAMATAN,13019,PAYUNG SEKAKI,3587,572,4159
2,KECAMATAN,13014,LEMBAH GUMANTI,19286,2441,21727
2,KECAMATAN,13096,DANAU KEMBAR,7174,746,7920
1,KABUPATEN/KOTA,13099,SIJUNJUNG,141142,23831,164973
2,KECAMATAN,13100,TANJUNG GADANG,8787,1879,10666
2,KECAMATAN,13108,SIJUNJUNG,16417,4014,20431
2,KECAMATAN,13118,IV NAGARI,6079,924,7003
2,KECAMATAN,13124,KAMANG BARU,14311,6826,21137
2,KECAMATAN,13136,LUBUAK TAROK,4601,2626,7227
2,KECAMATAN,13143,KOTO VII,11768,3037,14805
2,KECAMATAN,13149,SUMPUR KUDUS,7899,3756,11655
2,KECAMATAN,13158,KUPITAN,4641,1234,5875
1,KABUPATEN/KOTA,13163,TANAH DATAR,74503,24296,98799
2,KECAMATAN,13164,X KOTO,14816,3437,18253
2,KECAMATAN,13242,LINTAU BUO UTARA,8652,9698,18350
2,KECAMATAN,13239,TANJUANG BARU,5799,948,6747
2,KECAMATAN,13236,PADANG GANTING,4988,2093,7081
2,KECAMATAN,13229,SALIMPAUANG,8057,1692,9749
2,KECAMATAN,13222,PARIANGAN,7683,1711,9394
2,KECAMATAN,13211,SUNGAI TARAB,11803,2642,14445
2,KECAMATAN,13205,SUNGAYANG,6180,2312,8492
2,KECAMATAN,13200,LINTAU BUO,5338,3689,9027
2,KECAMATAN,13195,TANJUNG EMAS,9512,2338,11850
2,KECAMATAN,13189,LIMA KAUM,15118,3139,18257
2,KECAMATAN,13183,RAMBATAN,13817,2801,16618
2,KECAMATAN,13174,BATIPUH,10613,2865,13478
2,KECAMATAN,13248,BATIPUAH SELATAN,5057,822,5879
1,KABUPATEN/KOTA,13253,PADANG PARIAMAN,127433,40187,167620
2,KECAMATAN,13254,LUBUK ALUNG,14807,3443,18250
2,KECAMATAN,13308,PATAMUAN,0,0,0
2,KECAMATAN,13304,2 X 11 ENAM LINGKUNG,5922,2390,8312
2,KECAMATAN,13300,V KOTO TIMUR,0,0,0
2,KECAMATAN,13297,BATANG GASAN,4503,811,5314
2,KECAMATAN,13293,PADANG SAGO,0,0,0
2,KECAMATAN,13290,SINTUAK TOBOH GADANG,6880,1660,8540
2,KECAMATAN,13287,ULAKAN TAPAKIH,0,0,0
2,KECAMATAN,13285,IV KOTO AUR MALINTANG,0,0,0
2,KECAMATAN,13282,SUNGAI LIMAU,0,0,0
2,KECAMATAN,13279,SUNGAI GARINGGING,0,0,0
2,KECAMATAN,13276,V KOTO KAMPUNG DALAM,0,0,0
2,KECAMATAN,13271,VII KOTO SUNGAI SARIK,0,0,0
2,KECAMATAN,13266,2 X 11 KAYU TANAM,0,0,0
2,KECAMATAN,13260,NAN SABARIS,10825,2050,12875
2,KECAMATAN,13256,BATANG ANAI,14936,3786,18722
2,KECAMATAN,13311,ENAM LINGKUNG,0,0,0
1,KABUPATEN/KOTA,13317,AGAM,57873,14140,72013
2,KECAMATAN,13318,TANJUNG MUTIARA,0,0,0
2,KECAMATAN,13407,KAMANG MAGEK,9425,1691,11116
2,KECAMATAN,13403,CANDUNG,8670,1787,10457
2,KECAMATAN,13398,AMPEK NAGARI,8612,2306,10918
2,KECAMATAN,13392,SUNGAI PUA,9093,1753,10846
2,KECAMATAN,13385,PELEMBAYAN,11355,2205,13560
2,KECAMATAN,13380,PALUPUH,5158,1242,6400
2,KECAMATAN,13376,TILATANG KAMANG,14173,2953,17126
2,KECAMATAN,13369,BASO,12864,2871,15735
2,KECAMATAN,13361,IV ANGKAT CANDUNG,15606,3746,19352
2,KECAMATAN,13353,BANUHAMPU,14317,2522,16839
2,KECAMATAN,13345,IV KOTO,9894,1639,11533
2,KECAMATAN,13338,MATUR,7477,1340,8817
2,KECAMATAN,13328,TANJUNG RAYA,13017,2843,15860
2,KECAMATAN,13322,LUBUK BASUNG,0,0,0
2,KECAMATAN,13411,MALALAK,3628,613,4241
1,KABUPATEN/KOTA,13416,LIMA PULUH KOTA,143289,29511,172800
2,KECAMATAN,13417,SULIKI,5588,1711,7299
2,KECAMATAN,13495,BUKIK BARISAN,9332,1789,11121
2,KECAMATAN,13489,MUNGKA,9650,2084,11734
2,KECAMATAN,13483,SITUJUAH LIMO NAGARI,0,0,0
2,KECAMATAN,13474,LAREH SAGO HALABAN,0,0,0
2,KECAMATAN,13470,GUNUANG OMEH,4834,1426,6260
2,KECAMATAN,13462,KAPUR IX,0,0,0
2,KECAMATAN,13455,PANGKALAN KOTO BARU,10502,2272,12774
2,KECAMATAN,13443,HARAU,0,0,0
2,KECAMATAN,13438,LUAK,11062,2388,13450
2,KECAMATAN,13430,PAYAKUMBUH,12815,2761,15576
2,KECAMATAN,13424,GUGUAK,0,0,0
2,KECAMATAN,13501,AKABILURU,0,0,0
1,KABUPATEN/KOTA,13509,PASAMAN,63783,14431,78214
2,KECAMATAN,13510,BONJOL,8207,1880,10087
2,KECAMATAN,13546,RAO UTARA,4623,1040,5663
2,KECAMATAN,13544,PADANG GELUGUR,10148,2766,12914
2,KECAMATAN,13541,SIMPANG ALAHAN MATI,3971,661,4632
2,KECAMATAN,13538,MAPAT TUNGGUL SELATAN,3120,1120,4240
2,KECAMATAN,13535,RAO,7961,3385,11346
2,KECAMATAN,13531,TIGO NAGARI,7644,1702,9346
2,KECAMATAN,13528,DUO KOTO,7767,3060,10827
2,KECAMATAN,13524,MAPAT TUNGGUL,2915,1845,4760
2,KECAMATAN,13522,PANTI,9871,3635,13506
2,KECAMATAN,13515,LUBUK SIKAPING,19038,3231,22269
2,KECAMATAN,13550,RAO SELATAN,8978,2319,11297
1,KABUPATEN/KOTA,13554,KEPULAUAN MENTAWAI,94243,26644,120887
2,KECAMATAN,13555,PAGAI UTARA,0,0,0
2,KECAMATAN,13599,SIKAKAP,0,0,0
2,KECAMATAN,13592,SIPORA UTARA,0,0,0
2,KECAMATAN,13588,SIBERUT TENGAH,0,0,0
2,KECAMATAN,13584,SIBERUT BARAT DAYA,0,0,0
2,KECAMATAN,13580,SIBERUT BARAT,0,0,0
2,KECAMATAN,13573,SIBERUT UTARA,0,0,0
2,KECAMATAN,13567,SIBERUT SELATAN,0,0,0
2,KECAMATAN,13559,SIPORA SELATAN,0,0,0
2,KECAMATAN,13603,PAGAI SELATAN,0,0,0
1,KABUPATEN/KOTA,13608,DHARMASRAYA,0,0,0
2,KECAMATAN,13609,KOTO BARU,11072,4531,15603
2,KECAMATAN,83415,ASAM JUJUHAN,4257,1595,5852
2,KECAMATAN,83414,PADANG LAWEH,1983,1169,3152
2,KECAMATAN,83413,TIUMANG,3588,3345,6933
2,KECAMATAN,83412,KOTO SALAK,5324,4371,9695
2,KECAMATAN,83411,TIMPEH,4678,3173,7851
2,KECAMATAN,83410,SEMBILAN KOTO,2602,1145,3747
2,KECAMATAN,13630,SITIUNG,9578,3881,13459
2,KECAMATAN,13623,SUNGAI RUMBAI,5003,4837,9840
2,KECAMATAN,13617,PULAU PUNJUNG,14604,4167,18771
2,KECAMATAN,83416,KOTO BESAR,7452,4523,11975
1,KABUPATEN/KOTA,13634,SOLOK SELATAN,70141,36737,106878
2,KECAMATAN,13635,SANGIR,13722,4466,18188
2,KECAMATAN,13640,SUNGAI PAGU,11577,2697,14274
2,KECAMATAN,13652,KOTO PARIK GADANG DIATEH,7881,2064,9945
2,KECAMATAN,13657,SANGIR JUJUAN,5340,1078,6418
2,KECAMATAN,13663,SANGIR BATANG HARI,4920,2411,7331
2,KECAMATAN,13671,PAUH DUO,6413,1616,8029
2,KECAMATAN,13676,SANGIR BALAI JANGGO,6212,2771,8983
1,KABUPATEN/KOTA,13681,PASAMAN BARAT,56065,17103,73168
2,KECAMATAN,13682,SUNGAI BEREMAS,0,0,0
2,KECAMATAN,13707,LUHAK NAN DUO,0,0,0
2,KECAMATAN,13705,SUNGAI AUA,0,0,0
2,KECAMATAN,13703,KOTO BALINGKA,0,0,0
2,KECAMATAN,13700,RANAH BATAHAN,0,0,0
2,KECAMATAN,13697,GUNUNG TULEH,0,0,0
2,KECAMATAN,13694,KINALI,0,0,0
2,KECAMATAN,13690,TALAMAU,0,0,0
2,KECAMATAN,13686,PASAMAN,0,0,0
2,KECAMATAN,13684,LEMBAH MELINTANG,0,0,0
2,KECAMATAN,13710,SASAK RANAH PESISIA,0,0,0
1,KABUPATEN/KOTA,13712,KOTA PADANG,0,0,0
2,KECAMATAN,13713,PADANG SELATAN,18798,9241,28039
2,KECAMATAN,13807,NANGGALO,21193,5640,26833
2,KECAMATAN,13797,KURANJI,49937,9780,59717
2,KECAMATAN,13787,PAUH,22107,4039,26146
2,KECAMATAN,13779,LUBUK KILANGAN,18849,4298,23147
2,KECAMATAN,13763,LUBUK BEGALUNG,40781,10537,51318
2,KECAMATAN,13756,BUNGUS TELUK KABUNG,8788,1516,10304
2,KECAMATAN,13748,PADANG UTARA,20697,5443,26140
2,KECAMATAN,13737,PADANG BARAT,14282,8106,22388
2,KECAMATAN,13726,PADANG TIMUR,29436,7665,37101
2,KECAMATAN,13814,KOTO TANGAH,59982,17433,77415
1,KABUPATEN/KOTA,13828,KOTA SOLOK,304850,83698,388548
2,KECAMATAN,13829,LUBUK SIKARAH,14393,2644,17037
2,KECAMATAN,13837,TANJUNG HARAPAN,11256,2426,13682
1,KABUPATEN/KOTA,13844,KOTA SAWAHLUNTO,25649,5070,30719
2,KECAMATAN,13845,LEMBAH SEGAR,5128,1387,6515
2,KECAMATAN,13857,BARANGIN,7000,2017,9017
2,KECAMATAN,13868,SILUNGKANG,3880,1097,4977
2,KECAMATAN,13874,TALAWI,7466,2165,9631
1,KABUPATEN/KOTA,13886,KOTA PADANG PANJANG,23474,6666,30140
2,KECAMATAN,13887,PADANG PANJANG TIMUR,7967,1786,9753
2,KECAMATAN,13896,PADANG PANJANG BARAT,10980,2616,13596
1,KABUPATEN/KOTA,13905,KOTA BUKITTINGGI,18947,4402,23349
2,KECAMATAN,13906,GUGUAK PANJANG,14470,3681,18151
2,KECAMATAN,13924,AUR BIRUGO TIGO BALEH,9145,1894,11039
1,KABUPATEN/KOTA,13933,KOTA PAYAKUMBUH,23615,5575,29190
2,KECAMATAN,13934,PAYAKUMBUH BARAT,0,0,0
2,KECAMATAN,13966,PAYAKUMBUH UTARA,0,0,0
2,KECAMATAN,13995,PAYAKUMBUH TIMUR,0,0,0
2,KECAMATAN,83417,LAMPOSI TIGO NAGORI,0,0,0
2,KECAMATAN,83418,PAYAKUMBUH SELATAN,0,0,0
1,KABUPATEN/KOTA,14010,KOTA PARIAMAN,0,0,0
2,KECAMATAN,14011,PARIAMAN TENGAH,0,0,0
2,KECAMATAN,14034,PARIAMAN UTARA,0,0,0
2,KECAMATAN,14052,PARIAMAN SELATAN,0,0,0
2,KECAMATAN,14069,PARIAMAN TIMUR,0,0,0
0,PROVINSI,14086,RIAU,0,0,0
1,KABUPATEN/KOTA,14166,KAMPAR,0,0,0
2,KECAMATAN,14167,BANGKINANG,0,0,0
2,KECAMATAN,14344,SALO,0,0,0
2,KECAMATAN,14351,RUMBIO JAYA,0,0,0
2,KECAMATAN,14358,BANGKINANG SEBERANG,0,0,0
2,KECAMATAN,14368,PERHENTIAN RAJA,0,0,0
2,KECAMATAN,14373,KAMPAR TIMUR,0,0,0
2,KECAMATAN,14380,KAMPAR UTARA,0,0,0
2,KECAMATAN,14388,KAMPAR KIRI TENGAH,0,0,0
2,KECAMATAN,14400,GUNUNG SAHILAN,0,0,0
2,KECAMATAN,14330,TAPUNG HULU,0,0,0
2,KECAMATAN,14313,TAPUNG HILIR,0,0,0
2,KECAMATAN,14288,TAPUNG,0,0,0
2,KECAMATAN,14172,KAMPAR,0,0,0
2,KECAMATAN,14185,TAMBANG,0,0,0
2,KECAMATAN,14200,XIII KOTO KAMPAR,0,0,0
2,KECAMATAN,14214,KUOK,0,0,0
2,KECAMATAN,14221,SIAK HULU,0,0,0
2,KECAMATAN,14234,KAMPAR KIRI,0,0,0
2,KECAMATAN,14251,KAMPAR KIRI HILIR,0,0,0
2,KECAMATAN,14266,KAMPAR KIRI HULU,0,0,0
2,KECAMATAN,14407,KOTO KAMPAR HULU,0,0,0
1,KABUPATEN/KOTA,14414,INDRAGIRI HULU,0,0,0
2,KECAMATAN,14415,RENGAT,0,0,0
2,KECAMATAN,14599,RAKIT KULIM,0,0,0
2,KECAMATAN,14589,LUBUK BATU JAYA,0,0,0
2,KECAMATAN,14576,SUNGAI LALA,0,0,0
2,KECAMATAN,14565,KUALA CENAKU,0,0,0
2,KECAMATAN,14547,LIRIK,0,0,0
2,KECAMATAN,14536,BATANG GANGSAL,0,0,0
2,KECAMATAN,14515,BATANG CENAKU,0,0,0
2,KECAMATAN,14503,SIBERIDA,0,0,0
2,KECAMATAN,14490,PERANAP,0,0,0
2,KECAMATAN,14472,PASIR PENYU,0,0,0
2,KECAMATAN,14453,KELAYANG,0,0,0
2,KECAMATAN,14434,RENGAT BARAT,0,0,0
2,KECAMATAN,14619,BATANG PERANAP,0,0,0
1,KABUPATEN/KOTA,14630,BENGKALIS,0,0,0
2,KECAMATAN,14631,BENGKALIS,16789,19492,36281
2,KECAMATAN,14652,BANTAN,6261,12783,19044
2,KECAMATAN,14662,BUKIT BATU,7195,8878,16073
2,KECAMATAN,14678,MANDAU,62864,48405,111269
2,KECAMATAN,14694,RUPAT,4639,10921,15560
2,KECAMATAN,14707,RUPAT UTARA,2010,4412,6422
2,KECAMATAN,14713,SIAK KECIL,4122,6616,10738
2,KECAMATAN,14727,PINGGIR,12781,29362,42143
1,KABUPATEN/KOTA,14741,INDRAGIRI HILIR,116661,140869,257530
2,KECAMATAN,14742,RETEH,6818,11872,18690
2,KECAMATAN,14858,GAUNG,3890,10251,14141
2,KECAMATAN,14870,TEMBILAHAN HULU,8262,9519,17781
2,KECAMATAN,14875,KEMUNING,5547,9778,15325
2,KECAMATAN,14887,PELANGIRAN,7530,10750,18280
2,KECAMATAN,14902,TELUK BELENGKONG,1831,4209,6040
2,KECAMATAN,14916,PULAU BURUNG,3662,6237,9899
2,KECAMATAN,14932,CONCONG,1902,2585,4487
2,KECAMATAN,14939,KEMPAS,7234,9230,16464
2,KECAMATAN,14846,BATANG TUAKA,5321,4658,9979
2,KECAMATAN,14835,TANAH MERAH,4265,6252,10517
2,KECAMATAN,14753,ENOK,5876,9762,15638
2,KECAMATAN,14766,KUALA INDRAGIRI,2120,3762,5882
2,KECAMATAN,14775,TEMBILAHAN,16782,15154,31936
2,KECAMATAN,14782,TEMPULING,6121,7074,13195
2,KECAMATAN,14790,GAUNG ANAK SERKA,3727,5167,8894
2,KECAMATAN,14799,MANDAH,6031,9066,15097
2,KECAMATAN,14812,KATEMAN,6148,11228,17376
2,KECAMATAN,14821,KERITANG,8712,19039,27751
2,KECAMATAN,14948,SUNGAI BATANG,1866,3041,4907
1,KABUPATEN/KOTA,14955,PELALAWAN,113645,168634,282279
2,KECAMATAN,14956,UKUI,6226,11287,17513
2,KECAMATAN,15068,BANDAR SEI KIJANG,0,0,0
2,KECAMATAN,15057,KUALA KAMPAR,0,0,0
2,KECAMATAN,15047,TELUK MERANTI,0,0,0
2,KECAMATAN,15036,BUNUT,0,0,0
2,KECAMATAN,15025,KERUMUTAN,0,0,0
2,KECAMATAN,15015,PELALAWAN,0,0,0
2,KECAMATAN,15006,LANGGAM,0,0,0
2,KECAMATAN,14995,PANGKALAN LESUNG,5190,7422,12612
2,KECAMATAN,14977,PANGKALAN KURAS,9447,13425,22872
2,KECAMATAN,14968,PANGKALAN KERINCI,0,0,0
2,KECAMATAN,15074,BANDAR PETALANGAN,0,0,0
1,KABUPATEN/KOTA,15087,ROKAN HULU,20863,32134,52997
2,KECAMATAN,15088,UJUNG BATU,0,0,0
2,KECAMATAN,15242,KEPENUHAN HULU,0,0,0
2,KECAMATAN,15236,PAGARAN TAPAH DARUSSALAM,0,0,0
2,KECAMATAN,15228,BONAI DARUSSALAM,0,0,0
2,KECAMATAN,15221,KABUN,0,0,0
2,KECAMATAN,15211,TANDUN,0,0,0
2,KECAMATAN,15203,BANGUN PURBA,0,0,0
2,KECAMATAN,15191,TAMBUSAI UTARA,0,0,0
2,KECAMATAN,15177,RAMBAH HILIR,0,0,0
2,KECAMATAN,15162,RAMBAH SAMO,0,0,0
2,KECAMATAN,15148,KUNTO DARUSSALAM,0,0,0
2,KECAMATAN,15137,KEPENUHAN,0,0,0
2,KECAMATAN,15124,TAMBUSAI,0,0,0
2,KECAMATAN,15109,RAMBAH,0,0,0
2,KECAMATAN,15094,ROKAN IV KOTO,0,0,0
2,KECAMATAN,15248,PENDALIAN IV KOTO,0,0,0
1,KABUPATEN/KOTA,15254,ROKAN HILIR,0,0,0
2,KECAMATAN,15255,KUBU,3811,6624,10435
2,KECAMATAN,15401,PEKAITAN,1990,6877,8867
2,KECAMATAN,15396,RANTAU KOPAR,0,0,0
2,KECAMATAN,15390,BATU HAMPAR,0,0,0
2,KECAMATAN,15383,SIMPANG KANAN,0,0,0
2,KECAMATAN,15369,BANGKO PUSAKO,0,0,0
2,KECAMATAN,15363,TANAH PUTIH TANJUNG MELAWAN,0,0,0
2,KECAMATAN,15350,PUJUD,0,0,0
2,KECAMATAN,15345,SINABOI,2307,4039,6346
2,KECAMATAN,15338,PASIR LIMAU KAPAS,4920,10135,15055
2,KECAMATAN,15314,BAGAN SINEMBAH,28025,36760,64785
2,KECAMATAN,15301,RIMBA MELINTANG,6396,10380,16776
2,KECAMATAN,15287,TANAH PUTIH,11955,14995,26950
2,KECAMATAN,15271,BANGKO,19000,18967,37967
2,KECAMATAN,83476,KUBU BABUSSALAM,3401,6403,9804
1,KABUPATEN/KOTA,15412,SIAK,81805,115180,196985
2,KECAMATAN,15413,SIAK,6738,4063,10801
2,KECAMATAN,15537,MEMPURA,4380,2374,6754
2,KECAMATAN,15528,SABAK AUH,2828,2668,5496
2,KECAMATAN,15521,LUBUK DALAM,3304,5382,8686
2,KECAMATAN,15510,KANDIS,9204,18538,27742
2,KECAMATAN,15499,KOTO GASIB,4646,3688,8334
2,KECAMATAN,15488,BUNGA RAYA,5464,6569,12033
2,KECAMATAN,15475,KERINCI KANAN,4978,6490,11468
2,KECAMATAN,15463,DAYUN,5753,7306,13059
2,KECAMATAN,15453,SUNGAI MANDAU,2029,1366,3395
2,KECAMATAN,15444,TUALANG,27533,17667,45200
2,KECAMATAN,15438,MINAS,5636,5502,11138
2,KECAMATAN,15422,SUNGAI APIT,5613,7568,13181
2,KECAMATAN,15545,PUSAKO,1768,1188,2956
1,KABUPATEN/KOTA,15553,KUANTAN SINGINGI,89874,90369,180243
2,KECAMATAN,15554,KUANTAN MUDIK,6920,4427,11347
2,KECAMATAN,83478,SENTAJO RAYA,7298,7780,15078
2,KECAMATAN,83477,KUANTAN HILIR SEBERANG,2058,4193,6251
2,KECAMATAN,15763,HULU KUANTAN,1913,1913,3826
2,KECAMATAN,15751,INUMAN,2407,4376,6783
2,KECAMATAN,15737,LOGAS TANAH DARAT,4216,6376,10592
2,KECAMATAN,15722,PANGEAN,4788,4219,9007
2,KECAMATAN,15709,SINGINGI HILIR,7107,10333,17440
2,KECAMATAN,15695,GUNUNGTOAR,4098,2314,6412
2,KECAMATAN,15668,BENAI,4613,3492,8105
2,KECAMATAN,15655,CERENTI,3551,3203,6754
2,KECAMATAN,15626,KUANTAN HILIR,3500,3617,7117
2,KECAMATAN,15612,SINGINGI,6743,7972,14715
2,KECAMATAN,15585,KUANTAN TENGAH,13599,9329,22928
2,KECAMATAN,83479,PUCUK RANTAU,1783,2715,4498
1,KABUPATEN/KOTA,14087,KEPULAUAN MERANTI,74594,76259,150853
2,KECAMATAN,14088,TEBING TINGGI,0,0,0
2,KECAMATAN,14105,RANGSANG BARAT,0,0,0
2,KECAMATAN,14121,RANGSANG,0,0,0
2,KECAMATAN,14135,TEBING TINGGI BARAT,0,0,0
2,KECAMATAN,14144,MERBAU,0,0,0
2,KECAMATAN,83480,PULAUMERBAU,0,0,0
2,KECAMATAN,83481,TEBING TINGGI TIMUR,0,0,0
2,KECAMATAN,83482,TASIK PUTRI PUYU,0,0,0
2,KECAMATAN,83483,RANGSANG PESISIR,0,0,0
1,KABUPATEN/KOTA,15775,KOTA PEKANBARU,0,0,0
2,KECAMATAN,15776,SUKAJADI,0,0,0
2,KECAMATAN,15834,PAYUNG SEKAKI,21542,18654,40196
2,KECAMATAN,15829,TENAYAN RAYA,35014,20133,55147
2,KECAMATAN,15823,MARPOYAN DAMAI,37088,15061,52149
2,KECAMATAN,15818,TAMPAN,46591,16585,63176
2,KECAMATAN,15813,BUKIT RAYA,30135,10460,40595
2,KECAMATAN,15807,RUMBAI,16179,11664,27843
2,KECAMATAN,15800,SENAPELAN,10511,6906,17417
2,KECAMATAN,15795,LIMA PULUH,0,0,0
2,KECAMATAN,15791,SAIL,7270,2552,9822
2,KECAMATAN,15784,PEKANBARU KOTA,8588,2758,11346
2,KECAMATAN,15839,RUMBAI PESISIR,24020,8242,32262
1,KABUPATEN/KOTA,15846,KOTA DUMAI,236938,113015,349953
2,KECAMATAN,15847,DUMAI BARAT,8634,8526,17160
2,KECAMATAN,15858,DUMAI TIMUR,12643,13952,26595
2,KECAMATAN,15868,BUKIT KAPUR,7090,10694,17784
2,KECAMATAN,15874,SUNGAI SEMBILAN,3944,10744,14688
2,KECAMATAN,15880,MEDANG KAMPAI,2160,2569,4729
2,KECAMATAN,83421,DUMAI KOTA,10345,9291,19636
2,KECAMATAN,83422,DUMAI SELATAN,12695,9708,22403
0,PROVINSI,15885,JAMBI,0,0,0
1,KABUPATEN/KOTA,15961,KERINCI,57511,65484,122995
2,KECAMATAN,15962,GUNUNG RAYA,3254,1511,4765
2,KECAMATAN,83869,SIULAK MUKAI,1703,4138,5841
2,KECAMATAN,83484,AIR HANGAT BARAT,0,0,0
2,KECAMATAN,83423,BUKITKERMAN,0,0,0
2,KECAMATAN,16168,DEPATI TUJUH,9411,1087,10498
2,KECAMATAN,16140,SIULAK,0,0,0
2,KECAMATAN,16128,GUNUNG TUJUH,4804,2826,7630
2,KECAMATAN,16111,AIR HANGAT TIMUR,0,0,0
2,KECAMATAN,16081,KAYU ARO,6688,5817,12505
2,KECAMATAN,16060,KELILING DANAU,0,0,0
2,KECAMATAN,16045,BATANG MERANGIN,0,0,0
2,KECAMATAN,16033,GUNUNG KERINCI,0,0,0
2,KECAMATAN,16010,AIR HANGAT,0,0,0
2,KECAMATAN,15994,SITINJAU LAUT,0,0,0
2,KECAMATAN,15979,DANAU KERINCI,0,0,0
2,KECAMATAN,83870,KAYU ARO BARAT,7380,5302,12682
1,KABUPATEN/KOTA,16183,MERANGIN,33240,20681,53921
2,KECAMATAN,16184,JANGKAT,3823,2325,6148
2,KECAMATAN,16327,TABIR ILIR,1901,3670,5571
2,KECAMATAN,16335,TABIR TIMUR,1467,3009,4476
2,KECAMATAN,16340,RENAH PEMBARAP,4952,2115,7067
2,KECAMATAN,16353,PANGKALAN JAMBU,2766,1141,3907
2,KECAMATAN,16362,SUNGAI TENANG,3572,1763,5335
2,KECAMATAN,16375,RENAH PAMENANG,3617,4819,8436
2,KECAMATAN,16380,PAMENANG SELATAN,2785,2787,5572
2,KECAMATAN,16385,MARGO TABIR,3521,3851,7372
2,KECAMATAN,16392,TABIR LINTAS,1732,2476,4208
2,KECAMATAN,16398,TABIR BARAT,3337,2746,6083
2,KECAMATAN,16318,PAMENANG BARAT,3843,5362,9205
2,KECAMATAN,16307,BATANG MASUMAI,3954,1444,5398
2,KECAMATAN,16196,BANGKO,15527,9014,24541
2,KECAMATAN,16205,MUARA SIAU,2103,2841,4944
2,KECAMATAN,16223,SUNGAI MANAU,4176,1322,5498
2,KECAMATAN,16234,TABIR,7757,7323,15080
2,KECAMATAN,16246,PAMENANG,7719,10204,17923
2,KECAMATAN,16261,TABIR ULU,1889,2501,4390
2,KECAMATAN,16268,TABIR SELATAN,6435,9787,16222
2,KECAMATAN,16276,LEMBAH MASURAI,4810,6224,11034
2,KECAMATAN,16292,BANGKO  BARAT,2571,3643,6214
2,KECAMATAN,16299,NALO TATAN,3176,3784,6960
2,KECAMATAN,16413,TIANG PUMPUNG,1540,1256,2796
1,KABUPATEN/KOTA,16420,SAROLANGUN,98973,95407,194380
2,KECAMATAN,16421,BATANG ASAI,4821,3849,8670
2,KECAMATAN,16556,SINGKUT,8310,12660,20970
2,KECAMATAN,16539,BATHIN VIII,7002,4897,11899
2,KECAMATAN,16528,AIR HITAM,4078,8358,12436
2,KECAMATAN,16507,MANDIANGIN,5970,12813,18783
2,KECAMATAN,16492,PELAWAN,7793,8655,16448
2,KECAMATAN,16476,PAUH,3769,8414,12183
2,KECAMATAN,16460,SAROLANGUN,17727,9566,27293
2,KECAMATAN,16444,LIMUN,5585,4783,10368
2,KECAMATAN,16567,CERMIN NAN GEDANG,3543,2448,5991
1,KABUPATEN/KOTA,16576,BATANGHARI,68598,76443,145041
2,KECAMATAN,16577,MERSAM,6751,7857,14608
2,KECAMATAN,16594,MUARA TEMBESI,7589,7721,15310
2,KECAMATAN,16608,MUARA BULIAN,17517,13529,31046
2,KECAMATAN,16629,BATIN XXIV,4564,9778,14342
2,KECAMATAN,16647,PEMAYUNG,8011,8427,16438
2,KECAMATAN,16666,MARO SEBO ULU,5077,9527,14604
2,KECAMATAN,16681,BAJUBANG,6693,12232,18925
2,KECAMATAN,16691,MARO SEBO ILIR,3539,3928,7467
1,KABUPATEN/KOTA,16699,MUARO JAMBI,59741,72999,132740
2,KECAMATAN,16700,JAMBI LUAR KOTA,17456,15204,32660
2,KECAMATAN,16851,TAMAN RAJO,3570,3016,6586
2,KECAMATAN,16840,BAHAR SELATAN,3414,5524,8938
2,KECAMATAN,16813,SUNGAI GELAM,10668,23702,34370
2,KECAMATAN,16801,SUNGAI BAHAR,5289,8710,13999
2,KECAMATAN,16783,KUMPEH ULU,11373,14702,26075
2,KECAMATAN,16767,MESTONG,7528,13695,21223
2,KECAMATAN,16754,MARO SEBO,5282,5638,10920
2,KECAMATAN,16736,KUMPEH,5559,6227,11786
2,KECAMATAN,16719,SEKERNAN,8551,13151,21702
2,KECAMATAN,83485,BAHAR UTARA,2705,4563,7268
1,KABUPATEN/KOTA,16862,TANJUNG JABUNG BARAT,81395,114132,195527
2,KECAMATAN,16863,TUNGKAL ULU,2737,4201,6938
2,KECAMATAN,16933,KUALA BETARA,3531,3124,6655
2,KECAMATAN,16928,BRAM ITAM,3788,4532,8320
2,KECAMATAN,16923,SEBERANG KOTA,1896,2316,4212
2,KECAMATAN,16917,MUARA PAPALIK,2234,3363,5597
2,KECAMATAN,16910,RENAH MENDALUH,2281,3957,6238
2,KECAMATAN,16903,BATANG ASAM,4154,9031,13185
2,KECAMATAN,16897,TEBING TINGGI,8607,6973,15580
2,KECAMATAN,16888,MERLUNG,3325,4559,7884
2,KECAMATAN,16883,BETARA,4117,7705,11822
2,KECAMATAN,16878,PENGABUAN,5332,7031,12363
2,KECAMATAN,16871,TUNGKAL ILIR,16516,15705,32221
2,KECAMATAN,16938,SENYERANG,5288,6593,11881
1,KABUPATEN/KOTA,16946,TANJUNG JABUNG TIMUR,63806,79090,142896
2,KECAMATAN,16947,MUARA SABAK TIMUR,5789,11453,17242
2,KECAMATAN,17034,GERAGAI,4448,8985,13433
2,KECAMATAN,17026,MENDAHARA ULU,2975,5247,8222
2,KECAMATAN,17019,KUALA JAMBI,3044,4451,7495
2,KECAMATAN,17011,MUARA SABAK BARAT,3610,5136,8746
2,KECAMATAN,17003,DENDANG,3014,6001,9015
2,KECAMATAN,16993,S A D U,3519,4079,7598
2,KECAMATAN,16981,RANTAU RASAU,4989,7801,12790
2,KECAMATAN,16971,MENDAHARA,5514,8133,13647
2,KECAMATAN,16960,NIPAH PANJANG,5961,7281,13242
2,KECAMATAN,17044,BERBAK,2056,2864,4920
1,KABUPATEN/KOTA,17051,BUNGO,44919,71431,116350
2,KECAMATAN,17052,TANAH TUMBUH,3162,5439,8601
2,KECAMATAN,17195,TANAH SEPENGGAL LINTAS,5988,7546,13534
2,KECAMATAN,17189,BATHIN II PELAYANG,888,3187,4075
2,KECAMATAN,17179,BATHIN III ULU,1919,2437,4356
2,KECAMATAN,17174,RIMBO TENGAH,7962,4803,12765
2,KECAMATAN,17168,BUNGO DANI,8162,4587,12749
2,KECAMATAN,17159,BATHIN III,6653,4369,11022
2,KECAMATAN,17153,BATIN II BABEKO,2382,3401,5783
2,KECAMATAN,17135,PELEPAT ILIR,11089,15057,26146
2,KECAMATAN,17111,LIMBUR LUBUK MENGKUANG,8303,1842,10145
2,KECAMATAN,17097,PELEPAT,6234,10849,17083
2,KECAMATAN,17086,TANAH SEPENGGAL,5289,7291,12580
2,KECAMATAN,17077,JUJUHAN,4596,4038,8634
2,KECAMATAN,17071,PASAR MUARO BUNGO,7609,3796,11405
2,KECAMATAN,17064,RANTAU PANDAN,2998,2670,5668
2,KECAMATAN,17207,JUJUHAN ILIR,2762,3306,6068
1,KABUPATEN/KOTA,17215,TEBO,85996,84618,170614
2,KECAMATAN,17216,TEBO TENGAH,9219,9931,19150
2,KECAMATAN,17319,VII KOTO ILIR,2210,5414,7624
2,KECAMATAN,17310,SERAI SERUMPUN,1502,3127,4629
2,KECAMATAN,17304,TENGAH ILIR,3432,9269,12701
2,KECAMATAN,17294,RIMBO ILIR,5815,8805,14620
2,KECAMATAN,17287,RIMBO ULU,7310,14933,22243
2,KECAMATAN,17276,VII KOTO,3587,6576,10163
2,KECAMATAN,17263,SUMAY,2946,7022,9968
2,KECAMATAN,17254,RIMBO BUJANG,14800,20051,34851
2,KECAMATAN,17241,TEBO ULU,6341,9787,16128
2,KECAMATAN,17229,TEBO ILIR,6215,8066,14281
2,KECAMATAN,17325,MUARA TABIR,2795,5570,8365
1,KABUPATEN/KOTA,17333,KOTA JAMBI,66172,108551,174723
2,KECAMATAN,17334,TELANAIPURA,29777,20088,49865
2,KECAMATAN,17346,JAMBI SELATAN,33531,35684,69215
2,KECAMATAN,17356,JAMBI TIMUR,19590,24911,44501
2,KECAMATAN,17367,PASAR JAMBI,3149,3502,6651
2,KECAMATAN,17372,PELAYANGAN,4581,2503,7084
2,KECAMATAN,17379,DANAU TELUK,4582,2183,6765
2,KECAMATAN,17385,KOTA BARU,43981,37230,81211
2,KECAMATAN,17396,JELUTUNG,16369,16868,33237
1,KABUPATEN/KOTA,15886,KOTA SUNGAI PENUH,155560,142969,298529
2,KECAMATAN,15887,SUNGAIPENUH,3731,1303,5034
2,KECAMATAN,15907,PESISIR BUKIT,5100,1055,6155
2,KECAMATAN,15923,HAMPARAN RAWANG,7057,1294,8351
2,KECAMATAN,15937,TANAH KAMPUNG,3185,1254,4439
2,KECAMATAN,15951,KUMUN DEBAI,3362,1858,5220
2,KECAMATAN,83486,PONDOK TINGGI,6970,1819,8789
2,KECAMATAN,83487,KOTO BARU,3139,694,3833
2,KECAMATAN,83488,SUNGAIBUNGKAL,3837,1278,5115
0,PROVINSI,17404,SUMATERA SELATAN,0,0,0
1,KABUPATEN/KOTA,17405,OGAN KOMERING ULU,36381,10555,46936
2,KECAMATAN,17406,SOSOH BUAY RAYAP,3951,2281,6232
2,KECAMATAN,17557,SINAR PENINJAUAN,6014,6294,12308
2,KECAMATAN,17535,LENGKITI,7282,4320,11602
2,KECAMATAN,17520,LUBUK BATANG,9919,5519,15438
2,KECAMATAN,17498,SEMIDANG AJI,7504,3824,11328
2,KECAMATAN,17490,ULU OGAN,3309,770,4079
2,KECAMATAN,17476,BATURAJA TIMUR,30403,16271,46674
2,KECAMATAN,17463,BATURAJA BARAT,11318,7105,18423
2,KECAMATAN,17455,MUARA JAYA,2288,664,2952
2,KECAMATAN,17430,PENINJAUAN,13074,9287,22361
2,KECAMATAN,17417,PENGANDONAN,3286,1327,4613
2,KECAMATAN,17564,LUBUK RAJA,10299,6810,17109
1,KABUPATEN/KOTA,17570,OGAN KOMERING ILIR,108647,64472,173119
2,KECAMATAN,17571,TANJUNG LUBUK,0,0,0
2,KECAMATAN,17872,TELUK GELAM,0,0,0
2,KECAMATAN,17856,LEMPUING JAYA,0,0,0
2,KECAMATAN,17838,MESUJI RAYA,0,0,0
2,KECAMATAN,17817,MESUJI MAKMUR,0,0,0
2,KECAMATAN,17799,PANGKALAN LAMPAM,0,0,0
2,KECAMATAN,17787,CENGAL,0,0,0
2,KECAMATAN,17770,JEJAWI,0,0,0
2,KECAMATAN,17752,SUNGAI MENANG,0,0,0
2,KECAMATAN,17732,AIR SUGIHAN,0,0,0
2,KECAMATAN,17715,LEMPUING,0,0,0
2,KECAMATAN,17693,PAMPANGAN,0,0,0
2,KECAMATAN,17670,TULUNG SELAPAN,0,0,0
2,KECAMATAN,17649,SIRAH PULAU PADANG,0,0,0
2,KECAMATAN,17623,KAYU AGUNG,0,0,0
2,KECAMATAN,17608,MESUJI,0,0,0
2,KECAMATAN,17593,PEDAMARAN,0,0,0
2,KECAMATAN,17887,PEDAMARAN TIMUR,0,0,0
1,KABUPATEN/KOTA,17895,MUARA ENIM,0,0,0
2,KECAMATAN,17896,TANJUNG AGUNG,0,0,0
2,KECAMATAN,18142,RAMBANG,0,0,0
2,KECAMATAN,18156,SUNGAI ROTAN,0,0,0
2,KECAMATAN,18176,LEMBAK,0,0,0
2,KECAMATAN,18197,PENUKAL UTARA,0,0,0
2,KECAMATAN,18211,BENAKAT,0,0,0
2,KECAMATAN,18218,ABAB,0,0,0
2,KECAMATAN,18227,KELEKAR,0,0,0
2,KECAMATAN,18235,MUARA BELIDA,0,0,0
2,KECAMATAN,83489,BELIMBING,0,0,0
2,KECAMATAN,83490,BELINDA DARAT,0,0,0
2,KECAMATAN,18120,LUBAI,0,0,0
2,KECAMATAN,18106,PENUKAL,0,0,0
2,KECAMATAN,18088,TANAH ABANG,0,0,0
2,KECAMATAN,17923,MUARA ENIM,0,0,0
2,KECAMATAN,17940,RAMBANG DANGKU,0,0,0
2,KECAMATAN,17967,GUNUNG MEGANG,0,0,0
2,KECAMATAN,17991,TALANG UBI,0,0,0
2,KECAMATAN,18012,GELUMBANG,0,0,0
2,KECAMATAN,18036,LAWANG KIDUL,0,0,0
2,KECAMATAN,18044,SEMENDE DARAT LAUT,0,0,0
2,KECAMATAN,18055,SEMENDE DARAT TENGAH,0,0,0
2,KECAMATAN,18068,SEMENDE DARAT ULU,0,0,0
2,KECAMATAN,18079,UJAN MAS,0,0,0
2,KECAMATAN,83491,LUBAI ULU,0,0,0
1,KABUPATEN/KOTA,18244,LAHAT,0,0,0
2,KECAMATAN,18245,TANJUNGSAKTI PUMU,0,0,0
2,KECAMATAN,18516,PSEKSU,0,0,0
2,KECAMATAN,18528,GUMAY TALANG,0,0,0
2,KECAMATAN,18544,PAGAR GUNUNG,0,0,0
2,KECAMATAN,18565,MERAPI TIMUR,0,0,0
2,KECAMATAN,18580,TANJUNG SAKTI PUMI,0,0,0
2,KECAMATAN,18599,GUMAY ULU,0,0,0
2,KECAMATAN,18610,MERAPI SELATAN,0,0,0
2,KECAMATAN,18620,TANJUNGTEBAT,0,0,0
2,KECAMATAN,18635,MUARAPAYANG,0,0,0
2,KECAMATAN,18496,KIKIM BARAT,0,0,0
2,KECAMATAN,18486,KIKIM TENGAH,0,0,0
2,KECAMATAN,18260,JARAI,0,0,0
2,KECAMATAN,18282,KOTA AGUNG,0,0,0
2,KECAMATAN,18305,PULAUPINANG,0,0,0
2,KECAMATAN,18320,MERAPI BARAT,0,0,0
2,KECAMATAN,18340,LAHAT,0,0,0
2,KECAMATAN,18376,PAJAR BULAN,0,0,0
2,KECAMATAN,18407,MULAK ULU,0,0,0
2,KECAMATAN,18434,KIKIM SELATAN,0,0,0
2,KECAMATAN,18453,KIKIM TIMUR,0,0,0
2,KECAMATAN,83492,SUKAMERINDU,0,0,0
1,KABUPATEN/KOTA,18643,MUSI RAWAS,0,0,0
2,KECAMATAN,18644,TUGUMULYO,0,0,0
2,KECAMATAN,18833,PURWODADI,0,0,0
2,KECAMATAN,18865,KARANG JAYA,0,0,0
2,KECAMATAN,18880,NIBUNG,0,0,0
2,KECAMATAN,18892,KARANG DAPO,0,0,0
2,KECAMATAN,18902,TIANG PUMPUNG KEPUNGUT,0,0,0
2,KECAMATAN,18912,SUMBER HARTA,0,0,0
2,KECAMATAN,18922,TUAH NEGERI,0,0,0
2,KECAMATAN,18812,MEGANG SAKTI,0,0,0
2,KECAMATAN,18799,SELANGIT,0,0,0
2,KECAMATAN,18785,STL ULU TERAWAS,0,0,0
2,KECAMATAN,18662,MUARA LAKITAN,0,0,0
2,KECAMATAN,18683,MUARA KELINGI,0,0,0
2,KECAMATAN,18704,RAWAS ILIR,0,0,0
2,KECAMATAN,18716,RAWAS ULU,0,0,0
2,KECAMATAN,18733,ULU RAWAS,0,0,0
2,KECAMATAN,18741,RUPIT,0,0,0
2,KECAMATAN,18759,JAYALOKA,0,0,0
2,KECAMATAN,18772,MUARA BELITI,0,0,0
2,KECAMATAN,18934,SUKA KARYA,0,0,0
1,KABUPATEN/KOTA,18942,MUSI BANYUASIN,0,0,0
2,KECAMATAN,18943,SEKAYU,0,0,0
2,KECAMATAN,83426,LAWANG WETAN,0,0,0
2,KECAMATAN,83425,TUNGKAL JAYA,0,0,0
2,KECAMATAN,19145,LALAN,0,0,0
2,KECAMATAN,19130,PLAKAT TINGGI,0,0,0
2,KECAMATAN,19095,BAYUNG LENCIR,0,0,0
2,KECAMATAN,19081,KELUANG,0,0,0
2,KECAMATAN,19055,SUNGAI LILIN,0,0,0
2,KECAMATAN,19027,BABAT TOMAN,0,0,0
2,KECAMATAN,19009,SANGA DESA,0,0,0
2,KECAMATAN,18992,BATANG HARI LEKO,0,0,0
2,KECAMATAN,18972,SUNGAI KERUH,0,0,0
2,KECAMATAN,18958,LAIS,0,0,0
2,KECAMATAN,83427,BABAT SUPAT,0,0,0
1,KABUPATEN/KOTA,19172,BANYUASIN,0,0,0
2,KECAMATAN,19173,BANYUASIN I,0,0,0
2,KECAMATAN,83493,SUMBER MARGA TELANG,0,0,0
2,KECAMATAN,83430,SEMBAWA,0,0,0
2,KECAMATAN,83429,SUAK TAPEH,0,0,0
2,KECAMATAN,19479,AIR SALEK,0,0,0
2,KECAMATAN,19456,MUARA SUGIHAN,0,0,0
2,KECAMATAN,19440,TANJUNG LAGO,0,0,0
2,KECAMATAN,19425,TUNGKAL ILIR,0,0,0
2,KECAMATAN,19403,RANTAU BAYUR,0,0,0
2,KECAMATAN,19390,TALANG KELAPA,0,0,0
2,KECAMATAN,19375,MAKARTI JAYA,0,0,0
2,KECAMATAN,19352,MUARA TELANG,0,0,0
2,KECAMATAN,19336,MUARA PADANG,0,0,0
2,KECAMATAN,19315,RAMBUTAN,0,0,0
2,KECAMATAN,19293,BETUNG,0,0,0
2,KECAMATAN,19263,PULAU RIMAU,0,0,0
2,KECAMATAN,19224,BANYUASIN III,0,0,0
2,KECAMATAN,19202,BANYUASIN II,0,0,0
2,KECAMATAN,83494,AIR KUMBANG,0,0,0
1,KABUPATEN/KOTA,19492,OGAN KOMERING ULU TIMUR,0,0,0
2,KECAMATAN,19493,MARTAPURA,18924,8413,27337
2,KECAMATAN,19684,BUAY MADANG TIMUR,25069,10296,35365
2,KECAMATAN,19708,MADANG SUKU III,7916,6924,14840
2,KECAMATAN,19718,SEMENDAWAI BARAT,6071,4489,10560
2,KECAMATAN,19731,SEMENDAWAI TIMUR,8709,11847,20556
2,KECAMATAN,19749,JAYAPURA,3653,4309,7962
2,KECAMATAN,19758,BELITANG JAYA,5685,6716,12401
2,KECAMATAN,19772,BELITANG MADANG RAYA,15858,8806,24664
2,KECAMATAN,19788,BELITANG MULYA,7336,5088,12424
2,KECAMATAN,19675,BUNGA MAYANG,5155,3579,8734
2,KECAMATAN,19654,BELITANG III,11159,10420,21579
2,KECAMATAN,19510,BUAY MADANG,16800,5633,22433
2,KECAMATAN,19528,BELITANG,20440,10959,31399
2,KECAMATAN,19551,CEMPAKA,8171,5818,13989
2,KECAMATAN,19565,BUAY PEMUKA PELIUNG,12516,7643,20159
2,KECAMATAN,19579,MADANG SUKU II,11062,6549,17611
2,KECAMATAN,19596,MADANG SUKU I,12164,8339,20503
2,KECAMATAN,19609,SEMENDAWAI SUKU III,11753,10914,22667
2,KECAMATAN,19629,BELITANG II,11681,13684,25365
2,KECAMATAN,19800,BUAY PEMUKA BANGSA RAJA,5242,1877,7119
1,KABUPATEN/KOTA,19808,OGAN KOMERING ULU SELATAN,225364,152303,377667
2,KECAMATAN,19809,MUARA DUA,0,0,0
2,KECAMATAN,20066,TIGA DIHAJI,0,0,0
2,KECAMATAN,20057,BUANA PEMACA,0,0,0
2,KECAMATAN,20049,SINDANG DANAU,0,0,0
2,KECAMATAN,20039,SUNGAI ARE,0,0,0
2,KECAMATAN,20029,RUNJUNG AGUNG,0,0,0
2,KECAMATAN,20012,WARKUK RANAU SELATAN,0,0,0
2,KECAMATAN,19989,BUAY PEMATANG RIBU RANAU TENGAH,0,0,0
2,KECAMATAN,19979,KISAM ILIR,0,0,0
2,KECAMATAN,19959,KISAM TINGGI,0,0,0
2,KECAMATAN,19936,BUAY PEMACA,0,0,0
2,KECAMATAN,19920,MEKAKAU ILIR,0,0,0
2,KECAMATAN,19905,BUAY RUNJUNG,0,0,0
2,KECAMATAN,19888,BUAY SANDANG AJI,0,0,0
2,KECAMATAN,19880,SIMPANG,0,0,0
2,KECAMATAN,19861,MUARA DUA KISAM,0,0,0
2,KECAMATAN,19838,BANDING AGUNG,0,0,0
2,KECAMATAN,19824,PULAU BERINGIN,0,0,0
2,KECAMATAN,20075,BUAY RAWAN,0,0,0
1,KABUPATEN/KOTA,20087,OGAN ILIR,0,0,0
2,KECAMATAN,20088,MUARA KUANG,0,0,0
2,KECAMATAN,20320,LUBUK KELIAT,0,0,0
2,KECAMATAN,20306,RAMBANG KUANG,0,0,0
2,KECAMATAN,20293,KANDIS,0,0,0
2,KECAMATAN,20279,SUNGAI PINANG,0,0,0
2,KECAMATAN,20266,RANTAU PANJANG,0,0,0
2,KECAMATAN,20254,PEMULUTAN BARAT,0,0,0
2,KECAMATAN,20238,PEMULUTAN SELATAN,0,0,0
2,KECAMATAN,20223,INDRALAYA SELATAN,0,0,0
2,KECAMATAN,20206,INDRALAYA UTARA,0,0,0
2,KECAMATAN,20192,RANTAU ALAI,0,0,0
2,KECAMATAN,20166,PEMULUTAN,0,0,0
2,KECAMATAN,20145,INDRALAYA,0,0,0
2,KECAMATAN,20125,TANJUNG RAJA,0,0,0
2,KECAMATAN,20103,TANJUNG BATU,0,0,0
2,KECAMATAN,20331,PAYARAMAN,0,0,0
1,KABUPATEN/KOTA,20345,EMPAT LAWANG,0,0,0
2,KECAMATAN,20346,MUARA PINANG,0,0,0
2,KECAMATAN,83495,SALING,0,0,0
2,KECAMATAN,83431,SIKAP DALAM,0,0,0
2,KECAMATAN,20496,PASEMAH AIR KERUH,0,0,0
2,KECAMATAN,20482,TALANG PADANG,0,0,0
2,KECAMATAN,20464,LINTANG KANAN,0,0,0
2,KECAMATAN,20426,TEBING TINGGI,0,0,0
2,KECAMATAN,20400,ULU MUSI,0,0,0
2,KECAMATAN,20369,PENDOPO,0,0,0
2,KECAMATAN,83496,PENDOPO BARAT,0,0,0
1,KABUPATEN/KOTA,20512,KOTA PALEMBANG,0,0,0
2,KECAMATAN,20513,ILIR BARAT II,0,0,0
2,KECAMATAN,20618,PLAJU,24482,21746,46228
2,KECAMATAN,20611,KERTAPATI,23192,20737,43929
2,KECAMATAN,20605,GANDUS,17009,13804,30813
2,KECAMATAN,20598,BUKIT KECIL,11929,9431,21360
2,KECAMATAN,20592,KALIDONI,0,0,0
2,KECAMATAN,20585,KEMUNING,22231,20596,42827
2,KECAMATAN,20580,SAKO,0,0,0
2,KECAMATAN,20572,SUKARAMI,37593,36794,74387
2,KECAMATAN,20559,ILIR TIMUR II,44260,41162,85422
2,KECAMATAN,20547,ILIR TIMUR I,14921,23998,38919
2,KECAMATAN,20540,ILIR BARAT I,37846,30192,68038
2,KECAMATAN,20532,SEBERANG ULU II,25990,22029,48019
2,KECAMATAN,20521,SEBERANG ULU I,43087,40138,83225
2,KECAMATAN,20631,SEMATANG BORANG,10095,9480,19575
1,KABUPATEN/KOTA,20636,KOTA PAGAR ALAM,312635,290107,602742
2,KECAMATAN,20637,PAGAR ALAM UTARA,10883,9697,20580
2,KECAMATAN,20648,PAGAR ALAM SELATAN,12743,11880,24623
2,KECAMATAN,20657,DEMPO UTARA,0,0,0
2,KECAMATAN,20665,DEMPO SELATAN,0,0,0
2,KECAMATAN,20671,DEMPO TENGAH,3982,3741,7723
1,KABUPATEN/KOTA,20677,KOTA LUBUKLINGGAU,27608,25318,52926
2,KECAMATAN,20678,LUBUK LINGGAU TIMUR I,9128,5781,14909
2,KECAMATAN,20687,LUBUK LINGGAU BARAT I,9041,6624,15665
2,KECAMATAN,20699,LUBUK LINGGAU SELATAN I,4140,3578,7718
2,KECAMATAN,20707,LUBUK LINGGAU UTARA I,3219,5172,8391
2,KECAMATAN,20718,LUBUK LINGGAU TIMUR II,7461,8773,16234
2,KECAMATAN,20728,LUBUK LINGGAU BARAT II,6145,5141,11286
2,KECAMATAN,20737,LUBUK LINGGAU SELATAN II,8213,6481,14694
2,KECAMATAN,20747,LUBUK LINGGAU UTARA II,8457,8323,16780
1,KABUPATEN/KOTA,20758,KOTA PRABUMULIH,55804,49873,105677
2,KECAMATAN,20759,PRABUMULIH BARAT,0,0,0
2,KECAMATAN,20766,PRABUMULIH TIMUR,0,0,0
2,KECAMATAN,20775,CAMBAI,0,0,0
2,KECAMATAN,20781,RAMBANG KPK TENGAH,0,0,0
2,KECAMATAN,20791,PRABUMULIH UTARA,0,0,0
2,KECAMATAN,20797,PRABUMULIH SELATAN,0,0,0
0,PROVINSI,20802,BENGKULU,0,0,0
1,KABUPATEN/KOTA,20923,BENGKULU SELATAN,0,0,0
2,KECAMATAN,20924,KEDURANG,2269,3389,5658
2,KECAMATAN,21072,BUNGA MAS,1175,2145,3320
2,KECAMATAN,21061,ULU MANNA,1549,2612,4161
2,KECAMATAN,21050,AIR NIPIS,1575,3472,5047
2,KECAMATAN,21037,KEDURANG ILIR,1163,2962,4125
2,KECAMATAN,21015,PINO RAYA,2893,6548,9441
2,KECAMATAN,21003,KOTA MANNA,7696,6787,14483
2,KECAMATAN,20984,MANNA,3045,3989,7034
2,KECAMATAN,20967,PINO,2357,3805,6162
2,KECAMATAN,20944,SEGINIM,2195,5529,7724
2,KECAMATAN,21083,PASAR MANNA,5237,3726,8963
1,KABUPATEN/KOTA,21093,REJANG LEBONG,31154,44964,76118
2,KECAMATAN,21094,KOTA PADANG,2936,2311,5247
2,KECAMATAN,21243,SINDANG BELITI ILIR,0,0,0
2,KECAMATAN,21236,SINDANG DATARAN,2372,3168,5540
2,KECAMATAN,21226,SINDANG BELITI ULU,3196,2775,5971
2,KECAMATAN,21220,BINDURIANG,2024,2934,4958
2,KECAMATAN,21209,CURUP TENGAH,10518,6393,16911
2,KECAMATAN,21197,CURUP SELATAN,6994,3052,10046
2,KECAMATAN,21187,CURUP TIMUR,0,0,0
2,KECAMATAN,21172,CURUP UTARA,4986,3406,8392
2,KECAMATAN,21157,SELUPU REJANG,8279,7672,15951
2,KECAMATAN,21144,BERMANI ULU,3445,3253,6698
2,KECAMATAN,21134,CURUP,9087,5179,14266
2,KECAMATAN,21121,SINDANG KELINGI,3968,4448,8416
2,KECAMATAN,21105,PADANG ULAK TANDING,4389,5104,9493
2,KECAMATAN,21254,BERMANI ULU RAYA,2640,3001,5641
1,KABUPATEN/KOTA,21265,BENGKULU UTARA,64834,52696,117530
2,KECAMATAN,21266,ENGGANO,353,1119,1472
2,KECAMATAN,83499,ULOK KUPAI,2321,3735,6056
2,KECAMATAN,83497,ARMA JAYA,2495,3498,5993
2,KECAMATAN,83439,AIR PADANG,1053,2189,3242
2,KECAMATAN,83438,HULU PALIK,2153,3535,5688
2,KECAMATAN,21474,AIR NAPAL,2130,3141,5271
2,KECAMATAN,21456,AIR BESI,1836,3124,4960
2,KECAMATAN,21436,PUTRI HIJAU,6189,14071,20260
2,KECAMATAN,21417,NAPAL PUTIH,1468,2589,4057
2,KECAMATAN,21396,KETAHUN,7423,16588,24011
2,KECAMATAN,21380,BATIK NAU,1904,5531,7435
2,KECAMATAN,21356,LAIS,2630,4121,6751
2,KECAMATAN,21345,PADANG JAYA,6005,10204,16209
2,KECAMATAN,21339,GIRI MULYA,2545,6080,8625
2,KECAMATAN,21309,ARGA MAKMUR,10570,9445,20015
2,KECAMATAN,21273,KERKAP,2733,3738,6471
2,KECAMATAN,84087,TANJUNGAGUNG PALIK,1617,2626,4243
1,KABUPATEN/KOTA,21492,KAUR,55425,95334,150759
2,KECAMATAN,21493,KINAL,1295,1452,2747
2,KECAMATAN,21680,PADANG GUCI HILIR,774,1176,1950
2,KECAMATAN,21670,LUNGKANG KULE,848,884,1732
2,KECAMATAN,21657,TETAP,1648,2213,3861
2,KECAMATAN,21649,MUARA SAHUNG,1405,2251,3656
2,KECAMATAN,21637,LUAS,1594,1476,3070
2,KECAMATAN,21623,KELAM TENGAH,1477,1930,3407
2,KECAMATAN,21609,SEMIDANG GUMAY,1509,1902,3411
2,KECAMATAN,21591,NASAL,2242,5688,7930
2,KECAMATAN,21571,MAJE,2040,5192,7232
2,KECAMATAN,21551,KAUR SELATAN,4352,4152,8504
2,KECAMATAN,21541,KAUR TENGAH,1791,1031,2822
2,KECAMATAN,21529,KAUR UTARA,1593,1757,3350
2,KECAMATAN,21508,TANJUNG KEMUNING,2047,3866,5913
2,KECAMATAN,21690,PADANG GUCI HULU,1630,1486,3116
1,KABUPATEN/KOTA,21702,SELUMA,26245,36456,62701
2,KECAMATAN,21703,SUKARAJA,5255,11794,17049
2,KECAMATAN,21862,ULU TALO,1116,2004,3120
2,KECAMATAN,21852,TALO KECIL,1975,2843,4818
2,KECAMATAN,21840,SELUMA SELATAN,2511,3843,6354
2,KECAMATAN,21831,SELUMA UTARA,3101,2237,5338
2,KECAMATAN,21822,SELUMA TIMUR,2398,2652,5050
2,KECAMATAN,21813,SELUMA BARAT,1653,3074,4727
2,KECAMATAN,21800,LUBUK SANDI,2958,3066,6024
2,KECAMATAN,21787,AIR PERIUKAN,3396,8103,11499
2,KECAMATAN,21766,SEMIDANG ALAS MARAS,4585,6452,11037
2,KECAMATAN,21745,SEMIDANG ALAS,2385,4503,6888
2,KECAMATAN,21730,TALO,3001,2607,5608
2,KECAMATAN,21722,SELUMA,2107,2253,4360
2,KECAMATAN,21872,ILIR TALO,3446,4100,7546
1,KABUPATEN/KOTA,21885,MUKOMUKO,39887,59531,99418
2,KECAMATAN,21886,LUBUK PINANG,2938,3605,6543
2,KECAMATAN,22034,AIR DIKIT,1341,1969,3310
2,KECAMATAN,22025,AIR MAJUNTO,1735,4048,5783
2,KECAMATAN,22014,V KOTO,1560,1682,3242
2,KECAMATAN,22005,XIV KOTO,2269,3886,6155
2,KECAMATAN,21990,PENARIK,3657,8469,12126
2,KECAMATAN,21977,SELAGAN RAYA,1587,2072,3659
2,KECAMATAN,21963,TERAMANG JAYA,2115,3210,5325
2,KECAMATAN,21950,AIR RAMI,2532,3746,6278
2,KECAMATAN,21942,MALIN DEMAN,1470,1569,3039
2,KECAMATAN,21925,IPUH,4599,3303,7902
2,KECAMATAN,21913,PONDOK SUGUH,2448,2910,5358
2,KECAMATAN,21904,TERAS TERUNJAM,1292,2426,3718
2,KECAMATAN,21894,KOTA MUKOMUKO,4087,3800,7887
2,KECAMATAN,22042,SUNGAI RUMBAI,1409,2936,4345
1,KABUPATEN/KOTA,22052,LEBONG,35039,49631,84670
2,KECAMATAN,22053,RIMBO PENGADANG,1015,1395,2410
2,KECAMATAN,83445,URAM JAYA,1497,1342,2839
2,KECAMATAN,83444,AMEN,1926,2189,4115
2,KECAMATAN,83443,PELABAI,1106,1841,2947
2,KECAMATAN,83442,LEBONG SAKTI,2144,2533,4677
2,KECAMATAN,83441,BINGIN KUNING,2134,3030,5164
2,KECAMATAN,83440,TOPOS,2179,1273,3452
2,KECAMATAN,22106,LEBONG UTARA,3685,4223,7908
2,KECAMATAN,22093,LEBONG ATAS,1292,3201,4493
2,KECAMATAN,22080,LEBONG TENGAH,2062,2699,4761
2,KECAMATAN,22063,LEBONG SELATAN,2948,4071,7019
2,KECAMATAN,83446,PINANG BELAPIS,947,1572,2519
1,KABUPATEN/KOTA,22135,KEPAHIANG,22935,29369,52304
2,KECAMATAN,22136,BERMANI ILIR,4707,3749,8456
2,KECAMATAN,22154,UJAN MAS,5854,4247,10101
2,KECAMATAN,22172,TEBAT KARAI,3908,2894,6802
2,KECAMATAN,22187,KEPAHIANG,11782,8776,20558
2,KECAMATAN,22206,MERIGI,3112,2074,5186
2,KECAMATAN,22215,KEBAWETAN,2751,4037,6788
2,KECAMATAN,22230,SEBERANG MUSI,1848,2038,3886
2,KECAMATAN,22241,MUARA KEMUMU,7875,4840,12715
1,KABUPATEN/KOTA,20803,BENGKULU TENGAH,41837,32655,74492
2,KECAMATAN,20804,KARANG TINGGI,3222,4033,7255
2,KECAMATAN,83434,PONDOK KUBANG,1887,3093,4980
2,KECAMATAN,83433,MERIGI SAKTI,1680,1577,3257
2,KECAMATAN,83432,MERIGI KELINDANG,1939,1992,3931
2,KECAMATAN,20899,TABA PENANJUNG,3001,3085,6086
2,KECAMATAN,20877,PAGAR JATI,2139,1495,3634
2,KECAMATAN,20856,PEMATANG TIGA,1688,2119,3807
2,KECAMATAN,20832,PONDOK KELAPA,6299,9254,15553
2,KECAMATAN,20818,TALANG EMPAT,2864,5044,7908
2,KECAMATAN,83435,BANG HAJI,1321,1839,3160
1,KABUPATEN/KOTA,22252,KOTA BENGKULU,26040,33531,59571
2,KECAMATAN,22253,SELEBAR,13191,14343,27534
2,KECAMATAN,22260,GADING CEMPAKA,11391,9534,20925
2,KECAMATAN,22272,TELUK SEGARA,6580,6028,12608
2,KECAMATAN,22286,MUARA BANGKA HULU,8978,9713,18691
2,KECAMATAN,22294,KAMPUNG MELAYU,5941,10124,16065
2,KECAMATAN,22301,RATU AGUNG,13362,12179,25541
2,KECAMATAN,22310,RATU SAMBAN,6364,5628,11992
2,KECAMATAN,22320,SUNGAI SERUT,5649,5477,11126
2,KECAMATAN,83447,SINGARAN PATI,9676,10109,19785
0,PROVINSI,22328,LAMPUNG,0,0,0
1,KABUPATEN/KOTA,22605,LAMPUNG SELATAN,81132,83135,164267
2,KECAMATAN,22606,NATAR,47475,48609,96084
2,KECAMATAN,22861,WAY SULAN,5586,5523,11109
2,KECAMATAN,22852,TANJUNG SARI,5253,11441,16694
2,KECAMATAN,22846,BAKAUHENI,4849,6914,11763
2,KECAMATAN,22830,MERBAU MATARAM,11085,15336,26421
2,KECAMATAN,22815,CANDIPURO,10428,17781,28209
2,KECAMATAN,22799,RAJA BASA,6766,5739,12505
2,KECAMATAN,22788,SRAGI,6015,10701,16716
2,KECAMATAN,22771,KETAPANG,9411,16970,26381
2,KECAMATAN,22749,JATI AGUNG,23310,39079,62389
2,KECAMATAN,22727,PALAS,11593,18557,30150
2,KECAMATAN,22704,PENENGAHAN,12876,8009,20885
2,KECAMATAN,22690,KATIBUNG,14360,19665,34025
2,KECAMATAN,22674,SIDOMULYO,13677,17155,30832
2,KECAMATAN,22646,KALIANDA,27326,18077,45403
2,KECAMATAN,22629,TANJUNG BINTANG,18312,21523,39835
2,KECAMATAN,22870,WAY PANJI,3043,6742,9785
1,KABUPATEN/KOTA,22875,LAMPUNG TENGAH,231365,287821,519186
2,KECAMATAN,22876,KALIREJO,0,0,0
2,KECAMATAN,23063,SEPUTIH AGUNG,0,0,0
2,KECAMATAN,23073,WAY PANGUBUAN,0,0,0
2,KECAMATAN,23080,BANDAR MATARAM,0,0,0
2,KECAMATAN,23089,PUBIAN,0,0,0
2,KECAMATAN,23108,SELAGAI LINGGA,6962,10519,17481
2,KECAMATAN,23121,ANAK TUHA,9261,10591,19852
2,KECAMATAN,23134,SENDANG AGUNG,7971,11593,19564
2,KECAMATAN,23144,KOTA GAJAH,0,0,0
2,KECAMATAN,23151,BUMI NABUNG,6403,11524,17927
2,KECAMATAN,23158,WAY SEPUTIH,4372,5452,9824
2,KECAMATAN,23165,BANDAR SURABAYA,0,0,0
2,KECAMATAN,23175,ANAK RATU AJI,4765,4801,9566
2,KECAMATAN,23054,BEKRI,5992,7848,13840
2,KECAMATAN,23044,BUMI RATU NUBAN,0,0,0
2,KECAMATAN,22890,BANGUN REJO,13338,17207,30545
2,KECAMATAN,22906,PADANG RATU,11954,14615,26569
2,KECAMATAN,22921,GUNUNG SUGIH,21134,15244,36378
2,KECAMATAN,22937,TRIMURJO,14700,15086,29786
2,KECAMATAN,22952,PUNGGUR,10383,10495,20878
2,KECAMATAN,22962,TERBANGGI BESAR,30702,28699,59401
2,KECAMATAN,22973,SEPUTIH RAMAN,11382,15761,27143
2,KECAMATAN,22988,RUMBIA,0,0,0
2,KECAMATAN,22997,SEPUTIH BANYAK,10431,15373,25804
2,KECAMATAN,23009,SEPUTIH MATARAM,0,0,0
2,KECAMATAN,23022,SEPUTIH SURABAYA,0,0,0
2,KECAMATAN,23036,TERUSAN NUNYAI,16298,8448,24746
2,KECAMATAN,23182,PUTRA RUMBIA,2984,7564,10548
1,KABUPATEN/KOTA,23189,LAMPUNG UTARA,189032,210820,399852
2,KECAMATAN,23190,BUKIT KEMUNING,12022,8881,20903
2,KECAMATAN,23359,ABUNG SURAKARTA,7638,7672,15310
2,KECAMATAN,23369,MUARA SUNGKAI,4600,3659,8259
2,KECAMATAN,23381,BUNGA MAYANG,9289,9801,19090
2,KECAMATAN,23393,HULU SUNGKAI,4298,3246,7544
2,KECAMATAN,23404,SUNGKAI TENGAH,3722,4817,8539
2,KECAMATAN,23413,ABUNG PEKURUN,3630,2241,5871
2,KECAMATAN,23423,SUNGKAI JAYA,2863,1477,4340
2,KECAMATAN,23433,SUNGKAI BARAT,3889,1979,5868
2,KECAMATAN,23444,ABUNG KUNANG,3602,1725,5327
2,KECAMATAN,23351,ABUNG SEMULI,6774,6828,13602
2,KECAMATAN,23342,ABUNG TINGGI,6167,2888,9055
2,KECAMATAN,23330,ABUNG TENGAH,4872,4274,9146
2,KECAMATAN,23199,KOTABUMI,17105,9815,26920
2,KECAMATAN,23213,SUNGKAI SELATAN,7158,4587,11745
2,KECAMATAN,23225,TANJUNG RAJA,10734,6405,17139
2,KECAMATAN,23245,ABUNG TIMUR,10640,9879,20519
2,KECAMATAN,23258,ABUNG BARAT,6751,3720,10471
2,KECAMATAN,23273,ABUNG SELATAN,13790,12211,26001
2,KECAMATAN,23290,SUNGKAI UTARA,9410,8598,18008
2,KECAMATAN,23306,KOTABUMI UTARA,8436,9019,17455
2,KECAMATAN,23315,KOTABUMI SELATAN,23409,10075,33484
2,KECAMATAN,23452,BLAMBANGAN PAGAR,5002,5087,10089
1,KABUPATEN/KOTA,23460,LAMPUNG BARAT,185801,138884,324685
2,KECAMATAN,23461,PESISIR SELATAN,4192,7113,11305
2,KECAMATAN,23621,GEDUNG SURIAN,3284,6243,9527
2,KECAMATAN,23627,NGAMBUR,2966,6534,9500
2,KECAMATAN,23637,BANGKUNAT BELIMBING,6748,7624,14372
2,KECAMATAN,23651,KRUI SELATAN,1876,2190,4066
2,KECAMATAN,23662,WAY KRUI,2098,2040,4138
2,KECAMATAN,23673,LUMBOK SEMINUNG,1344,2767,4111
2,KECAMATAN,23684,AIR HITAM,1855,5112,6967
2,KECAMATAN,23695,KEBUN TEBU,3788,6998,10786
2,KECAMATAN,23706,PAGAR DEWA,4442,7097,11539
2,KECAMATAN,23716,BATU KETULIS,3145,4511,7656
2,KECAMATAN,23727,BANDAR NEGERI SUOH,3554,12461,16015
2,KECAMATAN,23611,BENGKUNAT,1693,2637,4330
2,KECAMATAN,23597,LEMONG,2804,4201,7005
2,KECAMATAN,23477,PESISIR TENGAH,4901,3958,8859
2,KECAMATAN,23486,PESISIR UTARA,2334,1998,4332
2,KECAMATAN,23505,BALIK BUKIT,9850,9071,18921
2,KECAMATAN,23518,SUMBER JAYA,5894,6786,12680
2,KECAMATAN,23525,BELALAU,3214,4594,7808
2,KECAMATAN,23536,WAY TENONG,8031,7973,16004
2,KECAMATAN,23546,SEKINCAU,4000,6367,10367
2,KECAMATAN,23552,SUOH,2539,8688,11227
2,KECAMATAN,23561,BATU BRAK,4509,3365,7874
2,KECAMATAN,23573,SUKAU,5589,6182,11771
2,KECAMATAN,23584,KARYA PENGGAWA,2485,3268,5753
2,KECAMATAN,83871,PULAUPISANG,420,483,903
1,KABUPATEN/KOTA,23737,TULANG BAWANG,97555,140261,237816
2,KECAMATAN,23738,MENGGALA,0,0,0
2,KECAMATAN,23879,BANJAR BARU,0,0,0
2,KECAMATAN,23867,DENTE TELADAS,0,0,0
2,KECAMATAN,23862,GEDUNG AJI BARU,0,0,0
2,KECAMATAN,23853,MERAKSA AJI,0,0,0
2,KECAMATAN,23843,PENAWAR AJI,0,0,0
2,KECAMATAN,23833,RAWA PITU,0,0,0
2,KECAMATAN,23820,BANJAR MARGO,0,0,0
2,KECAMATAN,23811,RAWA JITU TIMUR,0,0,0
2,KECAMATAN,23796,PENAWAR TAMA,0,0,0
2,KECAMATAN,23785,RAWA JITU SELATAN,0,0,0
2,KECAMATAN,23773,GEDUNG MENENG,0,0,0
2,KECAMATAN,23760,BANJAR AGUNG,0,0,0
2,KECAMATAN,23749,GEDUNG AJI,0,0,0
2,KECAMATAN,23890,MENGGALA TIMUR,0,0,0
1,KABUPATEN/KOTA,23903,TANGGAMUS,0,0,0
2,KECAMATAN,23904,KOTA AGUNG,13219,8682,21901
2,KECAMATAN,24103,KOTA AGUNG BARAT,7870,2479,10349
2,KECAMATAN,24120,KOTA AGUNG TIMUR,5999,3851,9850
2,KECAMATAN,24132,GISTING,11552,10386,21938
2,KECAMATAN,24141,GUNUNG ALIP,7502,2452,9954
2,KECAMATAN,24153,LIMAU,5774,5649,11423
2,KECAMATAN,24164,BANDAR NEGERI SEMUONG,4143,2959,7102
2,KECAMATAN,24175,AIR NANINGAN,6446,9399,15845
2,KECAMATAN,24185,BULOK,5741,5552,11293
2,KECAMATAN,24094,KLUMBAYAN,3312,3053,6365
2,KECAMATAN,24080,PEMATANG SAWA,4187,5017,9204
2,KECAMATAN,23920,TALANG PADANG,15246,8169,23415
2,KECAMATAN,23940,WONOSOBO,9505,8407,17912
2,KECAMATAN,23964,PULAU PANGGUNG,10590,8366,18956
2,KECAMATAN,23983,CUKUH BALAK,6671,5921,12592
2,KECAMATAN,24002,PUGUNG,17210,12849,30059
2,KECAMATAN,24029,SEMAKA,9700,10814,20514
2,KECAMATAN,24050,SUMBER REJO,7162,11835,18997
2,KECAMATAN,24064,ULU BELU,8822,15824,24646
2,KECAMATAN,24195,KLUMBAYAN BARAT,2504,4011,6515
1,KABUPATEN/KOTA,24202,LAMPUNG TIMUR,163155,145675,308830
2,KECAMATAN,24203,SUKADANA,16048,20971,37019
2,KECAMATAN,24389,BUMI AGUNG,4028,6537,10565
2,KECAMATAN,24396,BANDAR SRIBHAWONO,8520,16946,25466
2,KECAMATAN,24404,MATARAM BARU,7243,6867,14110
2,KECAMATAN,24412,MELINTING,7092,6258,13350
2,KECAMATAN,24419,GUNUNG PELINDUNG,5656,4853,10509
2,KECAMATAN,24425,PASIR SAKTI,7267,11532,18799
2,KECAMATAN,24434,WAWAY KARYA,7262,11813,19075
2,KECAMATAN,24446,LABUHAN RATU,9509,14686,24195
2,KECAMATAN,24458,BRAJA SELEBAH,4243,7450,11693
2,KECAMATAN,24466,WAY BUNGUR,6184,6650,12834
2,KECAMATAN,24375,BATANGHARI NUBAN,13191,11497,24688
2,KECAMATAN,24359,SEKAMPUNG UDIK,12570,25441,38011
2,KECAMATAN,24221,LABUHAN MARINGGAI,15344,17773,33117
2,KECAMATAN,24233,JABUNG,14974,11938,26912
2,KECAMATAN,24249,PEKALONGAN,12982,14914,27896
2,KECAMATAN,24260,SEKAMPUNG,13038,22103,35141
2,KECAMATAN,24278,BATANGHARI,14832,17860,32692
2,KECAMATAN,24296,WAY JEPARA,11540,16469,28009
2,KECAMATAN,24312,PURBOLINGGO,11947,12203,24150
2,KECAMATAN,24325,RAMAN UTARA,8379,13592,21971
2,KECAMATAN,24337,METRO KIBANG,3696,8757,12453
2,KECAMATAN,24345,MARGA TIGA,9349,15063,24412
2,KECAMATAN,24475,MARGA SEKAMPUNG,5634,9094,14728
1,KABUPATEN/KOTA,24484,WAY KANAN,230528,311267,541795
2,KECAMATAN,24485,BLAMBANGAN UMPU,15627,17377,33004
2,KECAMATAN,24691,BUAY BAHUGA,6544,4884,11428
2,KECAMATAN,24680,NEGERI BESAR,3560,7351,10911
2,KECAMATAN,24665,NEGARA BATIN,6849,12418,19267
2,KECAMATAN,24645,GUNUNG LABUHAN,7220,7314,14534
2,KECAMATAN,24634,REBANG TANGKAS,4776,6773,11549
2,KECAMATAN,24621,WAY TUBA,6969,5816,12785
2,KECAMATAN,24602,NEGERI AGUNG,8245,12719,20964
2,KECAMATAN,24582,PAKUAN RATU,8196,15577,23773
2,KECAMATAN,24573,BAHUGA,2582,3552,6134
2,KECAMATAN,24550,BARADATU,10836,10975,21811
2,KECAMATAN,24529,BANJIT,10766,14072,24838
2,KECAMATAN,24510,KASUI,8025,8924,16949
2,KECAMATAN,24699,BUMI AGUNG,7544,7178,14722
1,KABUPATEN/KOTA,24850,PESAWARAN,107739,134930,242669
2,KECAMATAN,24851,GEDONG TATAAN,0,0,0
2,KECAMATAN,24871,NEGERI KATON,0,0,0
2,KECAMATAN,24892,TEGINENENG,0,0,0
2,KECAMATAN,24908,WAY LIMA,0,0,0
2,KECAMATAN,24925,PADANG CERMIN,0,0,0
2,KECAMATAN,24949,PUNDUH PIDADA,0,0,0
2,KECAMATAN,24972,KEDONDONG,0,0,0
2,KECAMATAN,83501,MARGA PUNDUH,0,0,0
2,KECAMATAN,83502,WAY KHILAU,0,0,0
1,KABUPATEN/KOTA,22329,PRINGSEWU,0,0,0
2,KECAMATAN,22330,PRINGSEWU,20392,23527,43919
2,KECAMATAN,22344,GADING REJO,21132,21505,42637
2,KECAMATAN,22360,AMBARAWA,8945,10042,18987
2,KECAMATAN,22368,PARDASUKA,9227,9407,18634
2,KECAMATAN,22381,PAGELARAN,14214,12974,27188
2,KECAMATAN,22406,BANYUMAS,5070,5724,10794
2,KECAMATAN,22416,ADILUWIH,8304,10223,18527
2,KECAMATAN,22425,SUKOHARJO,12013,12248,24261
2,KECAMATAN,83503,PAGELARAN UTARA,3380,4025,7405
1,KABUPATEN/KOTA,22439,MESUJI,102677,109675,212352
2,KECAMATAN,22440,MESUJI,3073,6557,9630
2,KECAMATAN,22450,MESUJI TIMUR,6093,11419,17512
2,KECAMATAN,22464,RAWA JITU UTARA,6025,7080,13105
2,KECAMATAN,22476,WAY SERDANG,8697,14530,23227
2,KECAMATAN,22490,SIMPANG PEMATANG,8152,5796,13948
2,KECAMATAN,22500,PANCA JAYA,3828,5505,9333
2,KECAMATAN,22508,TANJUNG RAYA,9256,11694,20950
1,KABUPATEN/KOTA,22522,TULANG BAWANG BARAT,45124,62581,107705
2,KECAMATAN,22523,TULANG BAWANG TENGAH,23535,22445,45980
2,KECAMATAN,22538,TULANG BAWANG UDIK,9087,8880,17967
2,KECAMATAN,22548,GUNUNG TERANG,6907,11290,18197
2,KECAMATAN,22560,LAMBU KIBANG,5716,7496,13212
2,KECAMATAN,22569,TUMIJAJAR,12035,12019,24054
2,KECAMATAN,22581,PAGAR DEWA,1567,1846,3413
2,KECAMATAN,22587,GUNUNG AGUNG,6252,11866,18118
2,KECAMATAN,22598,WAY KENANGA,3948,7789,11737
1,KABUPATEN/KOTA,24709,KOTA BANDAR LAMPUNG,69047,83631,152678
2,KECAMATAN,24710,KEDATON,13389,11950,25339
2,KECAMATAN,24806,SUKABUMI,14930,13529,28459
2,KECAMATAN,24814,KEMILING,20159,13893,34052
2,KECAMATAN,83504,LABUHAN RATU,12448,9195,21643
2,KECAMATAN,83505,WAY HALIM,14706,16777,31483
2,KECAMATAN,83506,LANGKAPURA,10345,6788,17133
2,KECAMATAN,83507,ENGGAL,7080,6082,13162
2,KECAMATAN,83508,KEDAMAIAN,11341,13007,24348
2,KECAMATAN,83509,TELUKBETUNG TIMUR,8894,11855,20749
2,KECAMATAN,24801,TANJUNG SENANG,12387,11279,23666
2,KECAMATAN,24796,RAJABASA,12873,8524,21397
2,KECAMATAN,24719,SUKARAME,16429,13325,29754
2,KECAMATAN,24725,TANJUNGKARANG BARAT,15070,12050,27120
2,KECAMATAN,24732,PANJANG,13157,21583,34740
2,KECAMATAN,24740,TANJUNGKARANG TIMUR,9096,9084,18180
2,KECAMATAN,24752,TANJUNGKARANG PUSAT,13571,11046,24617
2,KECAMATAN,24764,TELUKBETUNG SELATAN,8678,11231,19909
2,KECAMATAN,24776,TELUKBETUNG BARAT,7144,8133,15277
2,KECAMATAN,24785,TELUKBETUNG UTARA,12096,13208,25304
2,KECAMATAN,83510,BUMI WARAS,9732,17938,27670
1,KABUPATEN/KOTA,24822,KOTA METRO,243525,240477,484002
2,KECAMATAN,24823,METRO PUSAT,13634,12560,26194
2,KECAMATAN,24829,METRO UTARA,6733,7972,14705
2,KECAMATAN,24834,METRO BARAT,7103,7004,14107
2,KECAMATAN,24839,METRO TIMUR,10099,9804,19903
2,KECAMATAN,24845,METRO SELATAN,4363,4502,8865
0,PROVINSI,24993,KEPULAUAN BANGKA BELITUNG,0,0,0
1,KABUPATEN/KOTA,24994,BANGKA,41932,41842,83774
2,KECAMATAN,24995,SUNGAILIAT,0,0,0
2,KECAMATAN,25003,BELINYU,0,0,0
2,KECAMATAN,25012,MERAWANG,0,0,0
2,KECAMATAN,25023,MENDO BARAT,0,0,0
2,KECAMATAN,25037,PEMALI,0,0,0
2,KECAMATAN,25044,BAKAM,0,0,0
2,KECAMATAN,25054,RIAU SILIP,0,0,0
2,KECAMATAN,25064,PUDING BESAR,0,0,0
1,KABUPATEN/KOTA,25072,BELITUNG,0,0,0
2,KECAMATAN,25073,TANJUNG PANDAN,0,0,0
2,KECAMATAN,25086,MEMBALONG,0,0,0
2,KECAMATAN,25099,SELAT NASIK,0,0,0
2,KECAMATAN,25104,SIJUK,0,0,0
2,KECAMATAN,25113,BADAU,0,0,0
1,KABUPATEN/KOTA,25120,BANGKA SELATAN,0,0,0
2,KECAMATAN,25121,TOBOALI,9492,20385,29877
2,KECAMATAN,25133,LEPAR PONGOK,1035,2578,3613
2,KECAMATAN,25140,AIR GEGAS,4937,10700,15637
2,KECAMATAN,25151,SIMPANG RIMBA,2378,7674,10052
2,KECAMATAN,25159,PAYUNG,3945,5554,9499
2,KECAMATAN,25169,TUKAK SADAI,1253,4326,5579
2,KECAMATAN,25175,PULAUBESAR,1102,3247,4349
2,KECAMATAN,83511,KEPULAUAN PONGOK,432,1771,2203
1,KABUPATEN/KOTA,25181,BANGKA TENGAH,24574,56235,80809
2,KECAMATAN,25182,KOBA,5218,10397,15615
2,KECAMATAN,25194,PANGKALAN BARU,4402,13618,18020
2,KECAMATAN,25205,SUNGAI SELAN,3811,10194,14005
2,KECAMATAN,25217,SIMPANG KATIS,3609,5884,9493
2,KECAMATAN,25228,NAMANG,2417,4033,6450
2,KECAMATAN,25236,LUBUK BESAR,2621,8581,11202
1,KABUPATEN/KOTA,25245,BANGKA BARAT,22078,52707,74785
2,KECAMATAN,25246,MUNTOK,6764,15251,22015
2,KECAMATAN,25254,SIMPANG TERITIP,3094,9840,12934
2,KECAMATAN,25268,JEBUS,2873,6781,9654
2,KECAMATAN,25280,KELAPA,3832,11573,15405
2,KECAMATAN,25295,TEMPILANG,3330,9069,12399
2,KECAMATAN,25305,PARITTIGA,2588,12202,14790
1,KABUPATEN/KOTA,25316,BELITUNG TIMUR,22481,64716,87197
2,KECAMATAN,25317,MANGGAR,5785,12291,18076
2,KECAMATAN,25327,GANTUNG,3460,9386,12846
2,KECAMATAN,25335,DENDANG,1524,3909,5433
2,KECAMATAN,25340,KELAPA KAMPIT,3709,6222,9931
2,KECAMATAN,25347,DAMAR,1879,4620,6499
2,KECAMATAN,25353,SIMPANG RENGGIANG,1199,3025,4224
2,KECAMATAN,25358,SIMPANG PESAK,986,3364,4350
1,KABUPATEN/KOTA,25363,KOTA PANGKALPINANG,18542,42817,61359
2,KECAMATAN,25364,BUKITINTAN,4901,10417,15318
2,KECAMATAN,25372,TAMAN SARI,4880,4680,9560
2,KECAMATAN,25377,PANGKAL BALAM,3542,5719,9261
2,KECAMATAN,25388,RANGKUI,6481,9323,15804
2,KECAMATAN,25398,GERUNGGANG,8347,6642,14989
2,KECAMATAN,83512,GABEK,5096,6291,11387
2,KECAMATAN,83513,GIRIMAYA,2556,6631,9187
0,PROVINSI,25405,KEPULAUAN RIAU,0,0,0
1,KABUPATEN/KOTA,25471,BINTAN,35803,49703,85506
2,KECAMATAN,25472,GUNUNG KIJANG,2001,4687,6688
2,KECAMATAN,25522,BINTAN PESISIR,1111,2668,3779
2,KECAMATAN,25517,MANTANG,944,1081,2025
2,KECAMATAN,25512,TOAPAYA,1985,4026,6011
2,KECAMATAN,25504,TELOK SEBONG,2606,4966,7572
2,KECAMATAN,25495,TAMBELAN,945,1370,2315
2,KECAMATAN,25488,TELUK BINTAN,2081,3394,5475
2,KECAMATAN,25482,BINTAN UTARA,4073,5479,9552
2,KECAMATAN,25477,BINTAN TIMUR,8196,11772,19968
2,KECAMATAN,25527,SERI KUALA LOBAM,3175,4220,7395
1,KABUPATEN/KOTA,25533,KARIMUN,27117,43663,70780
2,KECAMATAN,25534,MORO,2902,6257,9159
2,KECAMATAN,83515,UNGAR,753,1828,2581
2,KECAMATAN,83514,MERAL BARAT,2673,3130,5803
2,KECAMATAN,25592,DURAI,1184,1655,2839
2,KECAMATAN,25586,KUNDUR BARAT,2488,6027,8515
2,KECAMATAN,25577,KUNDUR UTARA,1636,3855,5491
2,KECAMATAN,25572,BURU,0,0,0
2,KECAMATAN,25564,TEBING,0,0,0
2,KECAMATAN,25558,MERAL,0,0,0
2,KECAMATAN,25551,KARIMUN,0,0,0
2,KECAMATAN,25542,KUNDUR,3604,9532,13136
2,KECAMATAN,83516,BELAT,833,2161,2994
1,KABUPATEN/KOTA,25597,NATUNA,16073,34445,50518
2,KECAMATAN,25598,MIDAI,0,0,0
2,KECAMATAN,25673,BUNGURAN SELATAN,0,0,0
2,KECAMATAN,25669,BUNGURAN TENGAH,0,0,0
2,KECAMATAN,25661,BUNGURAN TIMUR LAUT,0,0,0
2,KECAMATAN,25650,PULAU TIGA,0,0,0
2,KECAMATAN,25646,PULAU LAUT,0,0,0
2,KECAMATAN,25637,SUBI,0,0,0
2,KECAMATAN,25628,BUNGURAN UTARA,0,0,0
2,KECAMATAN,25621,BUNGURAN TIMUR,0,0,0
2,KECAMATAN,25615,SERASAN,0,0,0
2,KECAMATAN,25605,BUNGURAN BARAT,0,0,0
2,KECAMATAN,25678,SERASAN TIMUR,0,0,0
1,KABUPATEN/KOTA,25683,LINGGA,0,0,0
2,KECAMATAN,25684,SINGKEP,4141,7582,11723
2,KECAMATAN,25696,LINGGA,1868,3880,5748
2,KECAMATAN,25715,SENAYANG,2671,7350,10021
2,KECAMATAN,25727,LINGGA UTARA,1757,3567,5324
2,KECAMATAN,25736,SINGKEP BARAT,1711,6401,8112
2,KECAMATAN,83517,SINGKEP PESISIR,636,1643,2279
2,KECAMATAN,83518,LINGGA TIMUR,711,1352,2063
2,KECAMATAN,83519,SELAYAR,523,1168,1691
1,KABUPATEN/KOTA,25429,KEPULAUAN ANAMBAS,14018,32943,46961
2,KECAMATAN,25430,SIANTAN,1505,3738,5243
2,KECAMATAN,25433,PALMATAK,1582,4248,5830
2,KECAMATAN,25443,SIANTAN TIMUR,407,1509,1916
2,KECAMATAN,25447,SIANTAN SELATAN,493,1384,1877
2,KECAMATAN,25454,JEMAJA TIMUR,299,879,1178
2,KECAMATAN,25459,JEMAJA,813,2073,2886
2,KECAMATAN,25467,SIANTAN TENGAH,369,1314,1683
1,KABUPATEN/KOTA,25746,KOTA BATAM,5468,15145,20613
2,KECAMATAN,25747,BELAKANG PADANG,0,0,0
2,KECAMATAN,25811,SAGULUNG,0,0,0
2,KECAMATAN,25804,BATAM KOTA,0,0,0
2,KECAMATAN,25799,BENGKONG,0,0,0
2,KECAMATAN,25790,GALANG,0,0,0
2,KECAMATAN,25785,SEI BEDUK,0,0,0
2,KECAMATAN,25779,LUBUK BAJA,0,0,0
2,KECAMATAN,25772,BULANG,0,0,0
2,KECAMATAN,25767,NONGSA,0,0,0
2,KECAMATAN,25759,SEKUPANG,0,0,0
2,KECAMATAN,25754,BATU AMPAR,0,0,0
2,KECAMATAN,25818,BATU AJI,0,0,0
1,KABUPATEN/KOTA,25406,KOTA TANJUNGPINANG,0,0,0
2,KECAMATAN,25407,TANJUNG PINANG BARAT,9135,14998,24133
2,KECAMATAN,25412,TANJUNG PINANG TIMUR,15927,17881,33808
2,KECAMATAN,25418,TANJUNG PINANG KOTA,2848,6745,9593
2,KECAMATAN,25423,BUKIT BESTARI,10354,15397,25751
0,PROVINSI,25823,DKI JAKARTA,0,0,0
1,KABUPATEN/KOTA,25824,KEPULAUAN SERIBU,38264,55021,93285
2,KECAMATAN,25825,KEPULAUAN SERIBU UTARA,4684,4977,9661
2,KECAMATAN,25829,KEPULAUAN SERIBU SELATAN,2222,3112,5334
1,KABUPATEN/KOTA,25833,JAKARTA PUSAT,6906,8089,14995
2,KECAMATAN,25834,GAMBIR,20496,30787,51283
2,KECAMATAN,25841,SAWAH BESAR,20833,46016,66849
2,KECAMATAN,25847,KEMAYORAN,57222,70723,127945
2,KECAMATAN,25856,SENEN,31210,33278,64488
2,KECAMATAN,25863,CEMPAKA PUTIH,26630,26216,52846
2,KECAMATAN,25867,MENTENG,24676,22392,47068
2,KECAMATAN,25873,TANAH ABANG,44003,42600,86603
2,KECAMATAN,25881,JOHAR BARU,33646,36654,70300
1,KABUPATEN/KOTA,25886,JAKARTA UTARA,258716,308666,567382
2,KECAMATAN,25887,PENJARINGAN,43759,114244,158003
2,KECAMATAN,25893,TANJUNG PRIOK,81605,119515,201120
2,KECAMATAN,25901,KOJA,76160,79492,155652
2,KECAMATAN,25908,CILINCING,93382,93794,187176
2,KECAMATAN,25916,PADEMANGAN,25556,56042,81598
2,KECAMATAN,25920,KELAPA GADING,22434,54308,76742
1,KABUPATEN/KOTA,25924,JAKARTA BARAT,342896,517395,860291
2,KECAMATAN,25925,CENGKARENG,93992,169742,263734
2,KECAMATAN,25932,GROGOL PETAMBURAN,34891,89315,124206
2,KECAMATAN,25940,TAMAN SARI,22009,46806,68815
2,KECAMATAN,25949,TAMBORA,47244,87464,134708
2,KECAMATAN,25961,KEBON JERUK,81193,94976,176169
2,KECAMATAN,25969,KALIDERES,82413,117760,200173
2,KECAMATAN,25975,PAL MERAH,56840,56627,113467
2,KECAMATAN,25982,KEMBANGAN,61233,79413,140646
1,KABUPATEN/KOTA,25989,JAKARTA SELATAN,479815,742103,1221918
2,KECAMATAN,25990,TEBET,0,0,0
2,KECAMATAN,26052,JAGAKARSA,0,0,0
2,KECAMATAN,26045,PANCORAN,0,0,0
2,KECAMATAN,26034,KEBAYORAN BARU,0,0,0
2,KECAMATAN,26028,CILANDAK,0,0,0
2,KECAMATAN,26021,KEBAYORAN LAMA,0,0,0
2,KECAMATAN,26013,PASAR MINGGU,85216,78402,163618
2,KECAMATAN,26007,MAMPANG PRAPATAN,0,0,0
2,KECAMATAN,25998,SETIABUDI,0,0,0
2,KECAMATAN,26059,PESANGGRAHAN,0,0,0
1,KABUPATEN/KOTA,26065,JAKARTA TIMUR,85216,78402,163618
2,KECAMATAN,26066,MATRAMAN,51239,45677,96916
2,KECAMATAN,26126,CIRACAS,78752,69201,147953
2,KECAMATAN,26120,MAKASAR,56742,51362,108104
2,KECAMATAN,26112,DUREN SAWIT,117132,105800,222932
2,KECAMATAN,26104,CAKUNG,140363,112921,253284
2,KECAMATAN,26098,PASAR REBO,61182,45274,106456
2,KECAMATAN,26090,KRAMATJATI,84430,65653,150083
2,KECAMATAN,26081,JATINEGARA,91053,82591,173644
2,KECAMATAN,26073,PULOGADUNG,74138,81732,155870
2,KECAMATAN,26132,CIPAYUNG,72928,56525,129453
0,PROVINSI,26141,JAWA BARAT,0,0,0
1,KABUPATEN/KOTA,26142,BOGOR,827959,716736,1544695
2,KECAMATAN,26143,CIBINONG,107445,58743,166188
2,KECAMATAN,26495,CIOMAS,53243,27936,81179
2,KECAMATAN,26485,CIJERUK,25985,11818,37803
2,KECAMATAN,26472,CARINGIN,43721,15682,59403
2,KECAMATAN,26460,MEGAMENDUNG,36197,15185,51382
2,KECAMATAN,26449,CISARUA,44885,17662,62547
2,KECAMATAN,26435,CIAWI,38803,15353,54156
2,KECAMATAN,26425,TENJO,18445,12889,31334
2,KECAMATAN,26409,CIGUDEG,33298,21573,54871
2,KECAMATAN,26507,DRAMAGA,33786,23243,57029
2,KECAMATAN,26518,TAMANSARI,31331,20948,52279
2,KECAMATAN,26595,LEUWISADENG,24764,9906,34670
2,KECAMATAN,26585,CIGOMBONG,31090,13430,44520
2,KECAMATAN,26577,TAJURHALANG,31562,21230,52792
2,KECAMATAN,26566,TANJUNGSARI,22245,7669,29914
2,KECAMATAN,26556,SUKAJAYA,23045,11893,34938
2,KECAMATAN,26548,RANCA BUNGUR,17186,11940,29126
2,KECAMATAN,26537,CISEENG,31951,21509,53460
2,KECAMATAN,26527,KLAPANUNGGAL,43103,11655,54758
2,KECAMATAN,26398,NANGGUNG,27599,16992,44591
2,KECAMATAN,26386,PARUNG PANJANG,29093,26034,55127
2,KECAMATAN,26245,SUKAMAKMUR,28131,10448,38579
2,KECAMATAN,26234,CARIU,23549,6800,30349
2,KECAMATAN,26221,CILEUNGSI,83013,39646,122659
2,KECAMATAN,26206,JONGGOL,54417,16908,71325
2,KECAMATAN,26196,BABAKAN MADANG,39316,12789,52105
2,KECAMATAN,26182,SUKARAJA,61972,28474,90446
2,KECAMATAN,26167,CITEUREUP,70371,28569,98940
2,KECAMATAN,26156,GUNUNG PUTRI,96077,45519,141596
2,KECAMATAN,26256,PARUNG,38083,24181,62264
2,KECAMATAN,26266,GUNUNG SINDUR,30396,24732,55128
2,KECAMATAN,26369,JASINGA,28354,16557,44911
2,KECAMATAN,26355,RUMPIN,37497,26711,64208
2,KECAMATAN,26339,PAMIJAHAN,44937,22589,67526
2,KECAMATAN,26323,CIBUNGBULANG,43046,24243,67289
2,KECAMATAN,26309,CIAMPEA,47438,32069,79507
2,KECAMATAN,26297,LEUWILIANG,40257,17777,58034
2,KECAMATAN,26287,BOJONG GEDE,72754,48959,121713
2,KECAMATAN,26277,KEMANG,29337,21546,50883
2,KECAMATAN,26604,TENJOLAYA,18412,11081,29493
1,KABUPATEN/KOTA,26611,SUKABUMI,1636134,852888,2489022
2,KECAMATAN,27020,CIAMBAR,14021,4480,18501
2,KECAMATAN,26920,KEBON PEDES,12296,3605,15901
2,KECAMATAN,26910,SUKARAJA,29368,11969,41337
2,KECAMATAN,26903,SUKABUMI,19933,6929,26862
2,KECAMATAN,26893,CARINGIN,17089,4643,21732
2,KECAMATAN,26883,KADUDAMPIT,23036,4405,27441
2,KECAMATAN,26869,CISAAT,49493,13342,62835
2,KECAMATAN,26861,CICANTAYAN,22413,6537,28950
2,KECAMATAN,26853,GUNUNG GURUH,16696,10206,26902
2,KECAMATAN,26844,CIRACAP,12743,12957,25700
2,KECAMATAN,26926,CIREUNGHAS,11934,3966,15900
2,KECAMATAN,26932,SUKALARANG,10061,7749,17810
2,KECAMATAN,26939,PABUARAN,13497,5910,19407
2,KECAMATAN,27013,CIMANGGU,7518,2940,10458
2,KECAMATAN,27004,TEGALBULEUD,10384,8152,18536
2,KECAMATAN,26999,CIDADAP,5974,4702,10676
2,KECAMATAN,26993,CIDOLOG,5690,4355,10045
2,KECAMATAN,26986,CURUG KEMBAR,8977,6652,15629
2,KECAMATAN,26974,SAGARANTEN,16677,9050,25727
2,KECAMATAN,26966,GEGER BITUNG,13345,6643,19988
2,KECAMATAN,26955,NYALINDUNG,17027,8251,25278
2,KECAMATAN,26947,PURABAYA,12734,7994,20728
2,KECAMATAN,26837,CIBITUNG,7843,4725,12568
2,KECAMATAN,26825,SURADE,22275,13833,36108
2,KECAMATAN,26817,KALIBUNDER,9238,3862,13100
2,KECAMATAN,26699,CIKEMBAR,30001,14115,44116
2,KECAMATAN,26688,WARUNG KIARA,19109,9274,28383
2,KECAMATAN,26676,JAMPANG TENGAH,21654,12415,34069
2,KECAMATAN,26670,LENGKONG,8482,4949,13431
2,KECAMATAN,26657,CIKIDANG,16104,9787,25891
2,KECAMATAN,26645,CISOLOK,17889,14646,32535
2,KECAMATAN,26637,BANTAR GADUNG,10444,5410,15854
2,KECAMATAN,26628,CIKAKAK,10342,7104,17446
2,KECAMATAN,26621,SIMPENAN,16730,9556,26286
2,KECAMATAN,26709,CIBADAK,38418,16815,55233
2,KECAMATAN,26720,NAGRAK,27516,15483,42999
2,KECAMATAN,26731,PARUNG KUDA,25828,9301,35129
2,KECAMATAN,26808,CIEMAS,13933,10864,24797
2,KECAMATAN,26797,JAMPANG KULON,14634,6655,21289
2,KECAMATAN,26791,WALURAN,8082,5091,13173
2,KECAMATAN,26784,KABANDUNGAN,11733,5710,17443
2,KECAMATAN,26776,KALAPA NUNGGAL,17602,4919,22521
2,KECAMATAN,26767,CIDAHU,23638,6806,30444
2,KECAMATAN,26753,CICURUG,44985,19284,64269
2,KECAMATAN,26746,PARAKAN SALAK,16409,4586,20995
2,KECAMATAN,26740,BOJONG GENTENG,14540,3557,18097
2,KECAMATAN,26612,PELABUHAN RATU,31467,18743,50210
1,KABUPATEN/KOTA,27026,CIANJUR,829802,392927,1222729
2,KECAMATAN,27027,CIANJUR,0,0,0
2,KECAMATAN,27247,PAGELARAN,0,0,0
2,KECAMATAN,27261,TANGGEUNG,0,0,0
2,KECAMATAN,27274,CIBINONG,0,0,0
2,KECAMATAN,27288,SINDANGBARANG,0,0,0
2,KECAMATAN,27298,AGRABINTA,0,0,0
2,KECAMATAN,27309,CIDAUN,0,0,0
2,KECAMATAN,27323,NARINGGUL,0,0,0
2,KECAMATAN,27334,CAMPAKAMULYA,0,0,0
2,KECAMATAN,27340,CIKADU,0,0,0
2,KECAMATAN,27350,GEKBRONG,0,0,0
2,KECAMATAN,27359,CIPANAS,0,0,0
2,KECAMATAN,27367,CIJATI,0,0,0
2,KECAMATAN,27377,LELES,0,0,0
2,KECAMATAN,27389,HAURWANGI,0,0,0
2,KECAMATAN,27233,KADUPANDAK,0,0,0
2,KECAMATAN,27223,TAKOKAK,0,0,0
2,KECAMATAN,27039,WARUNGKONDANG,0,0,0
2,KECAMATAN,27051,CIBEBER,0,0,0
2,KECAMATAN,27070,CILAKU,0,0,0
2,KECAMATAN,27081,CIRANJANG,0,0,0
2,KECAMATAN,27091,BOJONGPICUNG,0,0,0
2,KECAMATAN,27103,KARANGTENGAH,0,0,0
2,KECAMATAN,27120,MANDE,0,0,0
2,KECAMATAN,27133,SUKALUYU,0,0,0
2,KECAMATAN,27144,PACET,0,0,0
2,KECAMATAN,27152,CUGENANG,0,0,0
2,KECAMATAN,27169,CIKALONGKULON,0,0,0
2,KECAMATAN,27188,SUKARESMI,0,0,0
2,KECAMATAN,27200,SUKANAGARA,0,0,0
2,KECAMATAN,27211,CAMPAKA,0,0,0
2,KECAMATAN,27398,PASIRKUDA,0,0,0
1,KABUPATEN/KOTA,27407,BANDUNG,0,0,0
2,KECAMATAN,27408,CILEUNYI,59862,27140,87002
2,KECAMATAN,27566,CIPARAY,62511,24786,87297
2,KECAMATAN,27581,PACET,35103,18341,53444
2,KECAMATAN,27595,KERTASARI,30452,9076,39528
2,KECAMATAN,27603,BALEENDAH,82926,41624,124550
2,KECAMATAN,27612,MAJALAYA,53547,34445,87992
2,KECAMATAN,27624,SOLOKANJERUK,28651,18712,47363
2,KECAMATAN,27632,PASEH,35816,31428,67244
2,KECAMATAN,27645,IBUN,22914,22882,45796
2,KECAMATAN,27658,SOREANG,39922,21431,61353
2,KECAMATAN,27669,PASIRJAMBU,27468,19645,47113
2,KECAMATAN,27680,CIWIDEY,25975,18848,44823
2,KECAMATAN,27688,RANCABALI,16601,11857,28458
2,KECAMATAN,27694,CANGKUANG,23589,16224,39813
2,KECAMATAN,27552,RANCAEKEK,69199,22799,91998
2,KECAMATAN,27542,CIKANCUNG,28918,14776,43694
2,KECAMATAN,27535,NAGREG,17994,9503,27497
2,KECAMATAN,27415,CIMENYAN,33979,26828,60807
2,KECAMATAN,27425,CILENGKRANG,17007,9743,26750
2,KECAMATAN,27432,BOJONGSOANG,38930,17308,56238
2,KECAMATAN,27439,MARGAHAYU,35764,28405,64169
2,KECAMATAN,27445,MARGAASIH,42175,32381,74556
2,KECAMATAN,27452,KATAPANG,35809,25306,61115
2,KECAMATAN,27460,DAYEUHKOLOT,37072,21079,58151
2,KECAMATAN,27467,BANJARAN,44649,22642,67291
2,KECAMATAN,27479,PAMEUNGPEUK,30339,11092,41431
2,KECAMATAN,27486,PANGALENGAN,56347,25684,82031
2,KECAMATAN,27500,ARJASARI,34134,16384,50518
2,KECAMATAN,27512,CIMAUNG,24421,19288,43709
2,KECAMATAN,27522,CICALENGKA,44238,16492,60730
2,KECAMATAN,27702,KUTAWARINGIN,34797,18895,53692
1,KABUPATEN/KOTA,27714,GARUT,1171109,655044,1826153
2,KECAMATAN,28174,SUCINARAJA,9707,4407,14114
2,KECAMATAN,28067,CIKELET,14860,5883,20743
2,KECAMATAN,28056,CIBALONG,12961,9929,22890
2,KECAMATAN,28044,CISOMPET,15431,10583,26014
2,KECAMATAN,28036,PAMEUNGPEUK,16415,4952,21367
2,KECAMATAN,28029,PEUNDEUY,7306,2360,9666
2,KECAMATAN,28024,CIHURIP,5364,3368,8732
2,KECAMATAN,28014,SINGAJAYA,14071,6259,20330
2,KECAMATAN,28002,BANJARWANGI,18282,7485,25767
2,KECAMATAN,28077,BUNGBULANG,19611,9770,29381
2,KECAMATAN,28090,MEKARMUKTI,4901,3469,8370
2,KECAMATAN,28095,PAKENJENG,22614,9327,31941
2,KECAMATAN,28165,PANGATIKAN,13844,3388,17232
2,KECAMATAN,28159,CIBIUK,9768,3975,13743
2,KECAMATAN,28151,SELAAWI,13690,6021,19711
2,KECAMATAN,28128,TALEGONG,9988,6735,16723
2,KECAMATAN,28122,CARINGIN,9271,6273,15544
2,KECAMATAN,28114,CISEWU,13258,6407,19665
2,KECAMATAN,28108,PAMULIHAN,6468,2753,9221
2,KECAMATAN,27989,CIKAJANG,29211,11156,40367
2,KECAMATAN,27982,SUKARESMI,13396,4486,17882
2,KECAMATAN,27826,LELES,26191,13945,40136
2,KECAMATAN,27813,PASIRWANGI,25155,8343,33498
2,KECAMATAN,27800,SAMARANG,27174,9363,36537
2,KECAMATAN,27784,BANYURESMI,32595,9763,42358
2,KECAMATAN,27771,TAROGONG KIDUL,43410,15069,58479
2,KECAMATAN,27757,TAROGONG KALER,34797,13985,48782
2,KECAMATAN,27748,WANARAJA,16373,6532,22905
2,KECAMATAN,27727,KARANGPAWITAN,46147,17689,63836
2,KECAMATAN,27839,KADUNGORA,31164,14989,46153
2,KECAMATAN,27854,LEUWIGOONG,14634,6402,21036
2,KECAMATAN,27863,CIBATU,25295,8170,33465
2,KECAMATAN,27965,CISURUPAN,29731,17503,47234
2,KECAMATAN,27946,CILAWU,38972,15508,54480
2,KECAMATAN,27940,CIGEDUG,12059,5757,17816
2,KECAMATAN,27922,BAYONGBONG,32872,13104,45976
2,KECAMATAN,27917,KARANGTENGAH,5092,2056,7148
2,KECAMATAN,27905,SUKAWENING,18554,5816,24370
2,KECAMATAN,27881,MALANGBONG,40140,14810,54950
2,KECAMATAN,27875,KERSAMANAH,13528,4000,17528
2,KECAMATAN,27715,GARUT KOTA,46288,24890,71178
1,KABUPATEN/KOTA,28182,TASIKMALAYA,840588,356680,1197268
2,KECAMATAN,28183,CIPATUJAH,19862,15457,35319
2,KECAMATAN,28399,MANONJAYA,25975,8483,34458
2,KECAMATAN,28412,GUNUNG TANJUNG,11912,3273,15185
2,KECAMATAN,28420,SINGAPARNA,24243,11663,35906
2,KECAMATAN,28431,MANGUNREJA,14149,5986,20135
2,KECAMATAN,28438,SUKARAME,15518,4767,20285
2,KECAMATAN,28445,CIGALONTANG,27924,9978,37902
2,KECAMATAN,28462,LEUWISARI,13799,5599,19398
2,KECAMATAN,28470,PADAKEMBANG,13269,6229,19498
2,KECAMATAN,28476,SARIWANGI,12961,3259,16220
2,KECAMATAN,28485,SUKARATU,16205,7228,23433
2,KECAMATAN,28494,CISAYONG,18425,11092,29517
2,KECAMATAN,28508,SUKAHENING,9122,6232,15354
2,KECAMATAN,28516,RAJAPOLAH,17618,6936,24554
2,KECAMATAN,28525,JAMANIS,12367,4476,16843
2,KECAMATAN,28534,CIAWI,20339,10823,31162
2,KECAMATAN,28546,KADIPATEN,13792,3098,16890
2,KECAMATAN,28553,PAGERAGEUNG,21939,6145,28084
2,KECAMATAN,28394,KARANG JAYA,4317,3356,7673
2,KECAMATAN,28383,CINEAM,12674,7706,20380
2,KECAMATAN,28371,JATIWARAS,18085,6046,24131
2,KECAMATAN,28199,KARANGNUNGGAL,28840,15904,44744
2,KECAMATAN,28214,CIKALONG,23505,10269,33774
2,KECAMATAN,28228,PANCA TENGAH,18620,5382,24002
2,KECAMATAN,28240,CIKATOMAS,19550,7739,27289
2,KECAMATAN,28250,CIBALONG,12418,6320,18738
2,KECAMATAN,28257,PARUNGPONTENG,15518,3423,18941
2,KECAMATAN,28266,BANTARKALONG,14565,4525,19090
2,KECAMATAN,28275,BOJONGASIH,7889,2490,10379
2,KECAMATAN,28282,CULAMEGA,9884,2500,12384
2,KECAMATAN,28288,BOJONGGAMBIR,14580,5705,20285
2,KECAMATAN,28299,SODONGHILIR,27537,5986,33523
2,KECAMATAN,28312,TARAJU,12523,7120,19643
2,KECAMATAN,28322,SALAWU,22298,9920,32218
2,KECAMATAN,28335,PUSPAHIANG,9132,9192,18324
2,KECAMATAN,28344,TANJUNGJAYA,17264,5271,22535
2,KECAMATAN,28352,SUKARAJA,19855,7461,27316
2,KECAMATAN,28361,SALOPA,15122,7686,22808
2,KECAMATAN,28564,SUKARESIK,14160,3843,18003
1,KABUPATEN/KOTA,28573,CIAMIS,647755,268568,916323
2,KECAMATAN,28574,CIAMIS,0,0,0
2,KECAMATAN,28796,PADAHERANG,0,0,0
2,KECAMATAN,28811,KALIPUCANG,0,0,0
2,KECAMATAN,28821,PANGANDARAN,0,0,0
2,KECAMATAN,28830,SIDAMULIH,0,0,0
2,KECAMATAN,28838,PARIGI,0,0,0
2,KECAMATAN,28849,CIJULANG,0,0,0
2,KECAMATAN,28857,CIMERAK,0,0,0
2,KECAMATAN,28869,CIGUGUR,0,0,0
2,KECAMATAN,28877,LANGKAPLANCAR,0,0,0
2,KECAMATAN,28891,CIMARAGAS,0,0,0
2,KECAMATAN,28897,CISAGA,0,0,0
2,KECAMATAN,28909,SINDANGKASIH,0,0,0
2,KECAMATAN,28919,BAREGBEG,0,0,0
2,KECAMATAN,28929,SUKAMANTRI,0,0,0
2,KECAMATAN,28935,LUMBUNG,0,0,0
2,KECAMATAN,28944,PURWADADI,0,0,0
2,KECAMATAN,28782,PAMARICAN,0,0,0
2,KECAMATAN,28760,BANJARSARI,0,0,0
2,KECAMATAN,28587,CIKONENG,0,0,0
2,KECAMATAN,28597,CIJEUNGJING,0,0,0
2,KECAMATAN,28609,SADANANYA,0,0,0
2,KECAMATAN,28618,CIDOLOG,0,0,0
2,KECAMATAN,28625,CIHAURBEUTI,0,0,0
2,KECAMATAN,28637,PANUMBANGAN,0,0,0
2,KECAMATAN,28652,PANJALU,0,0,0
2,KECAMATAN,28661,KAWALI,0,0,0
2,KECAMATAN,28673,PANAWANGAN,0,0,0
2,KECAMATAN,28688,CIPAKU,0,0,0
2,KECAMATAN,28702,JATINAGARA,0,0,0
2,KECAMATAN,28709,RAJADESA,0,0,0
2,KECAMATAN,28721,SUKADANA,0,0,0
2,KECAMATAN,28728,RANCAH,0,0,0
2,KECAMATAN,28742,TAMBAKSARI,0,0,0
2,KECAMATAN,28749,LAKBOK,0,0,0
2,KECAMATAN,28954,MANGUNJAYA,0,0,0
1,KABUPATEN/KOTA,28960,KUNINGAN,0,0,0
2,KECAMATAN,28961,KADUGEDE,8638,6066,14704
2,KECAMATAN,29206,CIGUGUR,15165,11091,26256
2,KECAMATAN,29217,PASAWAHAN,5991,6443,12434
2,KECAMATAN,29228,NUSAHERANG,4992,5644,10636
2,KECAMATAN,29237,CIPICUNG,6167,6571,12738
2,KECAMATAN,29248,PANCALANG,6370,5577,11947
2,KECAMATAN,29262,JAPARA,4781,5740,10521
2,KECAMATAN,29273,CIMAHI,5934,8582,14516
2,KECAMATAN,29284,CILEBAK,3887,2589,6476
2,KECAMATAN,29292,HANTARA,3871,3643,7514
2,KECAMATAN,29301,KALIMANGGIS,5271,5278,10549
2,KECAMATAN,29308,CIBEUREUM,4879,5551,10430
2,KECAMATAN,29317,KARANG KANCANA,4947,4503,9450
2,KECAMATAN,29327,MALEBER,13430,6444,19874
2,KECAMATAN,29344,SINDANG AGUNG,9800,8197,17997
2,KECAMATAN,29186,DARMA,14967,9838,24805
2,KECAMATAN,29171,KRAMATMULYA,11438,10574,22012
2,KECAMATAN,28974,CINIRU,6094,3681,9775
2,KECAMATAN,28984,SUBANG,7343,1763,9106
2,KECAMATAN,28992,CIWARU,8230,6220,14450
2,KECAMATAN,29005,CIBINGBIN,9633,8669,18302
2,KECAMATAN,29016,LURAGUNG,13046,9025,22071
2,KECAMATAN,29033,LEBAKWANGI,10753,10202,20955
2,KECAMATAN,29047,GARAWANGI,11905,8335,20240
2,KECAMATAN,29065,KUNINGAN,35885,21691,57576
2,KECAMATAN,29082,CIAWIGEBANG,22506,17356,39862
2,KECAMATAN,29107,CIDAHU,10327,9357,19684
2,KECAMATAN,29120,JALAKSANA,11950,13142,25092
2,KECAMATAN,29136,CILIMUS,14394,11998,26392
2,KECAMATAN,29150,MANDIRANCAN,7015,5121,12136
2,KECAMATAN,29163,SELAJAMBE,4323,3705,8028
2,KECAMATAN,29357,CIGANDAMEKAR,8070,7560,15630
1,KABUPATEN/KOTA,29369,CIREBON,312002,250156,562158
2,KECAMATAN,29370,WALED,7538,15533,23071
2,KECAMATAN,29712,KALIWEDI,8168,9979,18147
2,KECAMATAN,29697,GEGESIK,15500,18798,34298
2,KECAMATAN,29684,SUSUKAN,11369,20285,31654
2,KECAMATAN,29675,CIWARINGIN,7755,11197,18952
2,KECAMATAN,29665,PANGURAGAN,9007,10494,19501
2,KECAMATAN,29653,ARJAWINANGUN,14579,19608,34187
2,KECAMATAN,29643,KLANGENAN,8728,16123,24851
2,KECAMATAN,29633,KAPETAKAN,10745,16487,27232
2,KECAMATAN,29722,GEBANG,8678,22672,31350
2,KECAMATAN,29736,DEPOK,11732,20515,32247
2,KECAMATAN,29815,SURANENGGALA,9593,14309,23902
2,KECAMATAN,29804,GREGED,8598,11674,20272
2,KECAMATAN,29795,GEMPOL,8811,14151,22962
2,KECAMATAN,29784,PLERED,9317,19213,28530
2,KECAMATAN,29775,TENGAH TANI,9005,13933,22938
2,KECAMATAN,29765,KARANGWARENG,3734,10083,13817
2,KECAMATAN,29757,PABUARAN,5536,13280,18816
2,KECAMATAN,29749,PASALEMAN,4466,7111,11577
2,KECAMATAN,29617,GUNUNG JATI,20705,23481,44186
2,KECAMATAN,29608,KEDAWUNG,14586,18019,32605
2,KECAMATAN,29471,SEDONG,5959,11819,17778
2,KECAMATAN,29457,SUSUKAN LEBAK,5487,12611,18098
2,KECAMATAN,29443,LEMAHABANG,10776,14888,25664
2,KECAMATAN,29434,KARANGSEMBUNG,6493,11353,17846
2,KECAMATAN,29419,BABAKAN,9756,23583,33339
2,KECAMATAN,29405,PABEDILAN,8678,19385,28063
2,KECAMATAN,29394,LOSARI,9989,17005,26994
2,KECAMATAN,29383,CILEDUG,10078,13216,23294
2,KECAMATAN,29482,ASTANAJAPURA,14839,16940,31779
2,KECAMATAN,29494,PANGENAN,7001,12415,19416
2,KECAMATAN,29598,WERU,14443,21069,35512
2,KECAMATAN,29582,PLUMBON,15970,26697,42667
2,KECAMATAN,29569,PALIMANAN,12916,18582,31498
2,KECAMATAN,29555,DUKUPUNTANG,13604,19718,33322
2,KECAMATAN,29540,SUMBER,17921,25894,43815
2,KECAMATAN,29528,TALUN,14149,17092,31241
2,KECAMATAN,29517,BEBER,8210,10023,18233
2,KECAMATAN,29504,MUNDU,15338,21179,36517
2,KECAMATAN,29825,JAMBLANG,5760,13273,19033
1,KABUPATEN/KOTA,29834,MAJALENGKA,415517,653687,1069204
2,KECAMATAN,29835,LEMAHSUGIH,0,0,0
2,KECAMATAN,30043,JATITUJUH,0,0,0
2,KECAMATAN,30059,LIGUNG,0,0,0
2,KECAMATAN,30079,SUMBERJAYA,0,0,0
2,KECAMATAN,30093,PANYINGKIRAN,0,0,0
2,KECAMATAN,30103,PALASAH,0,0,0
2,KECAMATAN,30117,CIGASONG,0,0,0
2,KECAMATAN,30128,SINDANGWANGI,0,0,0
2,KECAMATAN,30139,BANJARAN,0,0,0
2,KECAMATAN,30153,CINGAMBUL,0,0,0
2,KECAMATAN,30167,KASOKANDEL,0,0,0
2,KECAMATAN,30178,SINDANG,0,0,0
2,KECAMATAN,30028,KERTAJATI,0,0,0
2,KECAMATAN,30020,KADIPATEN,0,0,0
2,KECAMATAN,29852,BANTARUJEG,0,0,0
2,KECAMATAN,29866,CIKIJING,0,0,0
2,KECAMATAN,29882,TALAGA,0,0,0
2,KECAMATAN,29899,ARGAPURA,0,0,0
2,KECAMATAN,29914,MAJA,0,0,0
2,KECAMATAN,29933,MAJALENGKA,0,0,0
2,KECAMATAN,29948,SUKAHAJI,0,0,0
2,KECAMATAN,29962,RAJAGALUH,0,0,0
2,KECAMATAN,29976,LEUWIMUNDING,0,0,0
2,KECAMATAN,29991,JATIWANGI,0,0,0
2,KECAMATAN,30008,DAWUAN,0,0,0
2,KECAMATAN,30186,MALAUSMA,0,0,0
1,KABUPATEN/KOTA,30197,SUMEDANG,0,0,0
2,KECAMATAN,30198,WADO,13472,9410,22882
2,KECAMATAN,30364,JATINANGOR,37890,14635,52525
2,KECAMATAN,30377,RANCAKALONG,13189,10775,23964
2,KECAMATAN,30388,SUMEDANG SELATAN,31073,15435,46508
2,KECAMATAN,30403,SUMEDANG UTARA,33312,19340,52652
2,KECAMATAN,30417,GANEAS,8583,5009,13592
2,KECAMATAN,30425,TANJUNGKERTA,12391,8037,20428
2,KECAMATAN,30437,TANJUNGMEDAR,7977,7326,15303
2,KECAMATAN,30447,CIMALAKA,20547,13680,34227
2,KECAMATAN,30462,CISARUA,4985,5547,10532
2,KECAMATAN,30470,TOMO,7338,7831,15169
2,KECAMATAN,30480,UJUNGJAYA,8559,10523,19082
2,KECAMATAN,30352,CIMANGGUNG,37363,9987,47350
2,KECAMATAN,30340,PAMULIHAN,20302,12927,33229
2,KECAMATAN,30210,JATINUNGGAL,14850,9438,24288
2,KECAMATAN,30220,DARMARAJA,11863,9235,21098
2,KECAMATAN,30237,CIBUGEL,6688,4613,11301
2,KECAMATAN,30245,CISITU,8903,7274,16177
2,KECAMATAN,30256,SITURAJA,14367,8144,22511
2,KECAMATAN,30271,CONGGEANG,8921,10081,19002
2,KECAMATAN,30284,PASEH,10476,11184,21660
2,KECAMATAN,30295,SURIAN,3244,4012,7256
2,KECAMATAN,30304,BUAHDUA,10136,10231,20367
2,KECAMATAN,30319,TANJUNGSARI,33471,13838,47309
2,KECAMATAN,30332,SUKASARI,13736,6357,20093
2,KECAMATAN,30490,JATIGEDE,8211,7324,15535
1,KABUPATEN/KOTA,30503,INDRAMAYU,401847,252193,654040
2,KECAMATAN,30504,HAURGEULIS,19672,23661,43333
2,KECAMATAN,30707,LOHBENER,10425,19395,29820
2,KECAMATAN,30720,ARAHAN,6235,10834,17069
2,KECAMATAN,30729,LOSARANG,11448,17000,28448
2,KECAMATAN,30742,KANDANGHAUR,16269,27197,43466
2,KECAMATAN,30756,BONGAS,10345,15694,26039
2,KECAMATAN,30765,ANJATAN,15780,29609,45389
2,KECAMATAN,30779,SUKRA,8612,15622,24234
2,KECAMATAN,30788,GANTAR,15996,14124,30120
2,KECAMATAN,30795,TRISI,14216,16730,30946
2,KECAMATAN,30805,SUKAGUMIWANG,9282,8363,17645
2,KECAMATAN,30813,KEDOKAN BUNDER,10162,13842,24004
2,KECAMATAN,30821,PASEKAN,4037,8899,12936
2,KECAMATAN,30828,TUKDANA,14669,13602,28271
2,KECAMATAN,30699,CANTIGI,3563,9434,12997
2,KECAMATAN,30688,SINDANG,11934,15742,27676
2,KECAMATAN,30669,INDRAMAYU,26417,32843,59260
2,KECAMATAN,30515,KROYA,12121,20605,32726
2,KECAMATAN,30525,GABUSWETAN,11602,19176,30778
2,KECAMATAN,30536,CIKEDUNG,12042,11563,23605
2,KECAMATAN,30544,LELEA,11034,15901,26935
2,KECAMATAN,30556,BANGODUA,6050,8654,14704
2,KECAMATAN,30565,WIDASARI,7665,12359,20024
2,KECAMATAN,30576,KERTASEMAYA,11547,17620,29167
2,KECAMATAN,30590,KRANGKENG,13640,19495,33135
2,KECAMATAN,30602,KARANGAMPEL,12071,20542,32613
2,KECAMATAN,30614,JUNTINYUAT,18674,24118,42792
2,KECAMATAN,30627,SLIYEG,12422,22184,34606
2,KECAMATAN,30642,JATIBARANG,14193,25565,39758
2,KECAMATAN,30658,BALONGAN,10005,11049,21054
2,KECAMATAN,30842,PATROL,8916,19410,28326
1,KABUPATEN/KOTA,30851,SUBANG,371044,540832,911876
2,KECAMATAN,30852,SAGALAHERANG,0,0,0
2,KECAMATAN,31007,CIBOGO,11659,13304,24963
2,KECAMATAN,31017,CIPUNAGARA,0,0,0
2,KECAMATAN,31028,CIJAMBE,12697,10681,23378
2,KECAMATAN,31037,CIPEUNDUEY,13169,12726,25895
2,KECAMATAN,31045,LEGONKULON,5194,7827,13021
2,KECAMATAN,31053,CIKAUM,0,0,0
2,KECAMATAN,31063,SERANGPANJANG,0,0,0
2,KECAMATAN,31070,SUKASARI,0,0,0
2,KECAMATAN,31078,TAMBAKDAHAN,9266,16125,25391
2,KECAMATAN,31088,KASOMALANG,15433,7116,22549
2,KECAMATAN,31097,DAWUAN,12038,11779,23817
2,KECAMATAN,31108,PAGADEN BARAT,0,0,0
2,KECAMATAN,31118,CIATER,10547,6396,16943
2,KECAMATAN,30996,PATOKBEUSI,23878,19507,43385
2,KECAMATAN,30987,COMPRENG,8636,16198,24834
2,KECAMATAN,30860,CISALAK,0,0,0
2,KECAMATAN,30870,SUBANG,39761,31952,71713
2,KECAMATAN,30879,KALIJATI,0,0,0
2,KECAMATAN,30890,PABUARAN,0,0,0
2,KECAMATAN,30899,PURWADADI,0,0,0
2,KECAMATAN,30910,PAGADEN,17480,17404,34884
2,KECAMATAN,30921,BINONG,10487,16397,26884
2,KECAMATAN,30931,CIASEM,0,0,0
2,KECAMATAN,30941,PUSAKANAGARA,6908,14810,21718
2,KECAMATAN,30949,PAMANUKAN,12292,19202,31494
2,KECAMATAN,30958,JALANCAGAK,14437,10464,24901
2,KECAMATAN,30966,BLANAKAN,0,0,0
2,KECAMATAN,30976,TANJUNGSIANG,0,0,0
2,KECAMATAN,31126,PUSAKAJAYA,0,0,0
1,KABUPATEN/KOTA,31135,PURWAKARTA,223882,231888,455770
2,KECAMATAN,31136,PURWAKARTA,66104,27283,93387
2,KECAMATAN,31322,PONDOKSALAM,11799,4409,16208
2,KECAMATAN,31316,SUKASARI,5497,1952,7449
2,KECAMATAN,31305,CIBATU,11603,6094,17697
2,KECAMATAN,31294,BUNGURSARI,20520,8634,29154
2,KECAMATAN,31284,BABAKANCIKAO,18929,10049,28978
2,KECAMATAN,31269,BOJONG,18528,6826,25354
2,KECAMATAN,31256,PASAWAHAN,18701,7078,25779
2,KECAMATAN,31240,WANAYASA,15844,6393,22237
2,KECAMATAN,31226,TEGALWARU,18564,5632,24196
2,KECAMATAN,31217,MANIIS,9378,5677,15055
2,KECAMATAN,31201,DARANGDAN,24669,9197,33866
2,KECAMATAN,31186,SUKATANI,25873,8689,34562
2,KECAMATAN,31169,PLERED,28673,8135,36808
2,KECAMATAN,31158,JATILUHUR,25653,9773,35426
2,KECAMATAN,31147,CAMPAKA,17318,7361,24679
2,KECAMATAN,31334,KIARAPEDES,9606,5075,14681
1,KABUPATEN/KOTA,31345,KARAWANG,347259,138257,485516
2,KECAMATAN,31346,KARAWANG BARAT,0,0,0
2,KECAMATAN,31526,TELAGASARI,24019,13403,37422
2,KECAMATAN,31541,RAWAMERTA,18536,11045,29581
2,KECAMATAN,31555,LEMAHABANG,24144,12579,36723
2,KECAMATAN,31567,TEMPURAN,20067,15617,35684
2,KECAMATAN,31582,MAJALAYA,16638,9427,26065
2,KECAMATAN,31590,JAYAKERTA,16466,13440,29906
2,KECAMATAN,31599,CILAMAYA KULON,0,0,0
2,KECAMATAN,31612,BANYUSARI,0,0,0
2,KECAMATAN,31625,KOTA BARU,39077,24144,63221
2,KECAMATAN,31635,KARAWANG TIMUR,37638,26956,64594
2,KECAMATAN,31644,TELUKJAMBE BARAT,19937,10094,30031
2,KECAMATAN,31655,TEGALWARU,14777,4671,19448
2,KECAMATAN,31665,PURWASARI,0,0,0
2,KECAMATAN,31515,TIRTAMULYA,18591,9294,27885
2,KECAMATAN,31502,CILAMAYA WETAN,0,0,0
2,KECAMATAN,31355,PANGKALAN,0,0,0
2,KECAMATAN,31364,TELUKJAMBE TIMUR,39307,23257,62564
2,KECAMATAN,31374,CIAMPEL,0,0,0
2,KECAMATAN,31382,KLARI,0,0,0
2,KECAMATAN,31396,RENGASDENGKLOK,0,0,0
2,KECAMATAN,31406,KUTAWALUYA,17271,14119,31390
2,KECAMATAN,31419,BATUJAYA,22550,15006,37556
2,KECAMATAN,31430,TIRTAJAYA,19590,15152,34742
2,KECAMATAN,31442,PEDES,17848,19276,37124
2,KECAMATAN,31455,CIBUAYA,14042,11461,25503
2,KECAMATAN,31467,PAKISJAYA,0,0,0
2,KECAMATAN,31476,CIKAMPEK,0,0,0
2,KECAMATAN,31487,JATISARI,0,0,0
2,KECAMATAN,31674,CILEBAR,0,0,0
1,KABUPATEN/KOTA,31685,BEKASI,380498,248941,629439
2,KECAMATAN,31686,TARUMAJAYA,0,0,0
2,KECAMATAN,31813,SUKAKARYA,0,0,0
2,KECAMATAN,31821,SUKATANI,0,0,0
2,KECAMATAN,31829,CABANGBUNGIN,0,0,0
2,KECAMATAN,31838,MUARAGEMBONG,0,0,0
2,KECAMATAN,31845,SETU,0,0,0
2,KECAMATAN,31857,CIKARANG SELATAN,0,0,0
2,KECAMATAN,31865,CIKARANG PUSAT,0,0,0
2,KECAMATAN,31872,SERANG BARU,0,0,0
2,KECAMATAN,31881,CIBARUSAH,0,0,0
2,KECAMATAN,31799,PEBAYURAN,0,0,0
2,KECAMATAN,31791,KEDUNG WARINGIN,0,0,0
2,KECAMATAN,31782,CIKARANG TIMUR,0,0,0
2,KECAMATAN,31695,BABELAN,0,0,0
2,KECAMATAN,31705,SUKAWANGI,0,0,0
2,KECAMATAN,31713,TAMBELANG,0,0,0
2,KECAMATAN,31721,TAMBUN UTARA,0,0,0
2,KECAMATAN,31730,TAMBUN SELATAN,0,0,0
2,KECAMATAN,31741,CIBITUNG,0,0,0
2,KECAMATAN,31749,CIKARANG BARAT,0,0,0
2,KECAMATAN,31761,CIKARANG UTARA,0,0,0
2,KECAMATAN,31773,KARANG BAHAGIA,0,0,0
2,KECAMATAN,31889,BOJONGMANGU,0,0,0
1,KABUPATEN/KOTA,31896,BANDUNG BARAT,0,0,0
2,KECAMATAN,31897,LEMBANG,0,0,0
2,KECAMATAN,32067,GUNUNGHALU,0,0,0
2,KECAMATAN,32055,SINDANGKERTA,0,0,0
2,KECAMATAN,32046,RONGGA,0,0,0
2,KECAMATAN,32031,CIPONGKOR,0,0,0
2,KECAMATAN,32019,CILILIN,0,0,0
2,KECAMATAN,32008,CIHAMPELAS,0,0,0
2,KECAMATAN,31994,BATUJAJAR,0,0,0
2,KECAMATAN,31983,PADALARANG,0,0,0
2,KECAMATAN,31970,CIPATAT,0,0,0
2,KECAMATAN,31958,NGAMPRAH,0,0,0
2,KECAMATAN,31945,CIPEUNDEUY,0,0,0
2,KECAMATAN,31931,CIKALONGWETAN,0,0,0
2,KECAMATAN,31922,CISARUA,0,0,0
2,KECAMATAN,31914,PARONGPONG,0,0,0
2,KECAMATAN,83521,SAGULING,0,0,0
1,KABUPATEN/KOTA,32077,KOTA BOGOR,0,0,0
2,KECAMATAN,32078,BOGOR SELATAN,63572,40203,103775
2,KECAMATAN,32095,BOGOR TIMUR,30962,24809,55771
2,KECAMATAN,32102,BOGOR TENGAH,35204,24812,60016
2,KECAMATAN,32114,BOGOR BARAT,80800,45640,126440
2,KECAMATAN,32131,BOGOR UTARA,59389,35076,94465
2,KECAMATAN,32140,TANAH SAREAL,70359,40038,110397
1,KABUPATEN/KOTA,32152,KOTA SUKABUMI,340286,210578,550864
2,KECAMATAN,32153,GUNUNG PUYUH,17890,6826,24716
2,KECAMATAN,32158,CIKOLE,21602,11405,33007
2,KECAMATAN,32165,CITAMIANG,19578,7873,27451
2,KECAMATAN,32171,WARUDOYONG,19123,11009,30132
2,KECAMATAN,32177,BAROS,13394,4363,17757
2,KECAMATAN,32182,LEMBURSITU,13643,6666,20309
2,KECAMATAN,32188,CIBEUREUM,14888,4928,19816
1,KABUPATEN/KOTA,32193,KOTA BANDUNG,120118,53070,173188
2,KECAMATAN,32194,SUKASARI,25632,18094,43726
2,KECAMATAN,32302,BOJONGLOA KIDUL,24017,23318,47335
2,KECAMATAN,32309,CIBEUNYING KALER,22881,15770,38651
2,KECAMATAN,32314,SUMUR BANDUNG,11017,8609,19626
2,KECAMATAN,32319,ANTAPANI,25917,16876,42793
2,KECAMATAN,32324,BANDUNG KIDUL,18936,12553,31489
2,KECAMATAN,32329,BUAHBATU,33299,20405,53704
2,KECAMATAN,32334,RANCASARI,26610,16022,42632
2,KECAMATAN,32339,ARCAMANIK,23917,16172,40089
2,KECAMATAN,32344,CIBIRU,25092,12619,37711
2,KECAMATAN,32349,UJUNG BERUNG,28181,14642,42823
2,KECAMATAN,32355,GEDEBAGE,13205,6428,19633
2,KECAMATAN,32360,PANYILEUKAN,14204,6699,20903
2,KECAMATAN,32365,CINAMBO,8496,4349,12845
2,KECAMATAN,32295,KIARACONDONG,44161,28147,72308
2,KECAMATAN,32286,BANDUNG KULON,41286,30696,71982
2,KECAMATAN,32199,COBLONG,38984,25687,64671
2,KECAMATAN,32206,BABAKAN CIPARAY,36500,35783,72283
2,KECAMATAN,32213,BOJONGLOA KALER,34855,32257,67112
2,KECAMATAN,32219,ANDIR,28655,27537,56192
2,KECAMATAN,32226,CICENDO,28996,25276,54272
2,KECAMATAN,32233,SUKAJADI,31762,24987,56749
2,KECAMATAN,32239,CIDADAP,16777,13729,30506
2,KECAMATAN,32243,BANDUNG WETAN,8692,7826,16518
2,KECAMATAN,32247,ASTANA ANYAR,20059,21995,42054
2,KECAMATAN,32254,REGOL,23693,21675,45368
2,KECAMATAN,32262,BATUNUNGGAL,40037,27050,67087
2,KECAMATAN,32271,LENGKONG,22918,17045,39963
2,KECAMATAN,32279,CIBEUNYING KIDUL,36894,24708,61602
2,KECAMATAN,32370,MANDALAJATI,23030,14068,37098
1,KABUPATEN/KOTA,32375,KOTA CIREBON,778703,571022,1349725
2,KECAMATAN,32376,KEJAKSAN,12058,12504,24562
2,KECAMATAN,32381,LEMAH WUNGKUK,12261,18542,30803
2,KECAMATAN,32386,HARJAMUKTI,28150,28698,56848
2,KECAMATAN,32392,PEKALIPAN,6264,11358,17622
2,KECAMATAN,32397,KESAMBI,19626,19977,39603
1,KABUPATEN/KOTA,32403,KOTA BEKASI,78359,91079,169438
2,KECAMATAN,32404,BEKASI TIMUR,73480,64815,138295
2,KECAMATAN,32462,MUSTIKA JAYA,49876,36325,86201
2,KECAMATAN,32456,JATI SEMPURNA,26884,23834,50718
2,KECAMATAN,32449,JATIASIH,62360,44480,106840
2,KECAMATAN,32443,PONDOK GEDE,66618,56454,123072
2,KECAMATAN,32438,BANTAR GEBANG,27707,14303,42010
2,KECAMATAN,32433,MEDAN SATRIA,43566,38727,82293
2,KECAMATAN,32428,RAWA LUMBU,54573,50487,105060
2,KECAMATAN,32422,BEKASI SELATAN,56601,50641,107242
2,KECAMATAN,32415,BEKASI UTARA,96021,73139,169160
2,KECAMATAN,32409,BEKASI BARAT,79543,67270,146813
2,KECAMATAN,32467,PONDOK MELATI,34176,35050,69226
1,KABUPATEN/KOTA,32472,KOTA DEPOK,671405,555525,1226930
2,KECAMATAN,32473,PANCORAN MAS,0,0,0
2,KECAMATAN,32531,TAPOS,0,0,0
2,KECAMATAN,32526,CINERE,0,0,0
2,KECAMATAN,32520,CILODONG,0,0,0
2,KECAMATAN,32514,CIPAYUNG,0,0,0
2,KECAMATAN,32507,BEJI,0,0,0
2,KECAMATAN,32500,SUKMAJAYA,0,0,0
2,KECAMATAN,32495,LIMO,0,0,0
2,KECAMATAN,32487,SAWANGAN,0,0,0
2,KECAMATAN,32480,CIMANGGIS,0,0,0
2,KECAMATAN,32539,BOJONGSARI,0,0,0
1,KABUPATEN/KOTA,32547,KOTA CIMAHI,0,0,0
2,KECAMATAN,32548,CIMAHI SELATAN,85382,43134,128516
2,KECAMATAN,32554,CIMAHI TENGAH,59660,28868,88528
2,KECAMATAN,32561,CIMAHI UTARA,53456,32237,85693
1,KABUPATEN/KOTA,32566,KOTA TASIKMALAYA,198498,104239,302737
2,KECAMATAN,32567,CIHIDEUNG,25963,16277,42240
2,KECAMATAN,32631,BUNGURSARI,20866,7088,27954
2,KECAMATAN,32622,MANGKUBUMI,38334,12700,51034
2,KECAMATAN,32613,TAMANSARI,28315,8268,36583
2,KECAMATAN,32603,CIBEUREUM,28649,8063,36712
2,KECAMATAN,32592,KAWALU,38167,11917,50084
2,KECAMATAN,32585,INDIHIANG,22235,6874,29109
2,KECAMATAN,32579,TAWANG,26321,11037,37358
2,KECAMATAN,32574,CIPEDES,33848,11706,45554
2,KECAMATAN,32639,PURBARATU,18967,5377,24344
1,KABUPATEN/KOTA,32646,KOTA BANJAR,281665,99307,380972
2,KECAMATAN,32647,BANJAR,18978,13087,32065
2,KECAMATAN,32655,PATARUMAN,17984,15160,33144
2,KECAMATAN,32664,PURWAHARJA,7099,5856,12955
2,KECAMATAN,32669,LANGEN SARI,12508,15561,28069
0,PROVINSI,32676,JAWA TENGAH,0,0,0
1,KABUPATEN/KOTA,32677,CILACAP,56569,49664,106233
2,KECAMATAN,32690,KESUGIHAN,0,0,0
2,KECAMATAN,83525,JERUKLEGI,0,0,0
2,KECAMATAN,83526,WANAREJA,0,0,0
2,KECAMATAN,83527,DAYEUHLUHUR,0,0,0
2,KECAMATAN,83528,SAMPANG,0,0,0
2,KECAMATAN,83529,CIPARI,0,0,0
2,KECAMATAN,83530,PATIMUAN,0,0,0
2,KECAMATAN,83531,BANTARSARI,0,0,0
2,KECAMATAN,83532,CILACAP SELATAN,0,0,0
2,KECAMATAN,83533,CILACAP TENGAH,0,0,0
2,KECAMATAN,83534,CILACAP UTARA,0,0,0
2,KECAMATAN,83524,MAOS,0,0,0
2,KECAMATAN,83523,KROYA,0,0,0
2,KECAMATAN,32707,ADIPALA,0,0,0
2,KECAMATAN,32724,BINANGUN,0,0,0
2,KECAMATAN,32742,NUSAWUNGU,0,0,0
2,KECAMATAN,32803,KAWUNGANTEN,0,0,0
2,KECAMATAN,32816,GANDRUNGMANGU,0,0,0
2,KECAMATAN,32831,SIDAREJA,0,0,0
2,KECAMATAN,32842,KARANGPUCUNG,0,0,0
2,KECAMATAN,32857,CIMANGGU,0,0,0
2,KECAMATAN,32873,MAJENANG,0,0,0
2,KECAMATAN,83522,KEDUNGREJA,0,0,0
2,KECAMATAN,83535,KAMPUNG LAUT,0,0,0
1,KABUPATEN/KOTA,32986,BANYUMAS,0,0,0
2,KECAMATAN,32987,LUMBIR,0,0,0
2,KECAMATAN,33178,PEKUNCEN,0,0,0
2,KECAMATAN,33195,CILONGOK,0,0,0
2,KECAMATAN,33216,KARANG LEWAS,0,0,0
2,KECAMATAN,33230,SOKARAJA,0,0,0
2,KECAMATAN,33249,KEMBARAN,0,0,0
2,KECAMATAN,33266,SUMBANG,0,0,0
2,KECAMATAN,33286,BATURADEN,0,0,0
2,KECAMATAN,33299,KEDUNG BANTENG,0,0,0
2,KECAMATAN,33314,PURWOKERTO SELATAN,0,0,0
2,KECAMATAN,33322,PURWOKERTO BARAT,0,0,0
2,KECAMATAN,33330,PURWOKERTO TIMUR,0,0,0
2,KECAMATAN,33167,GUMELAR,0,0,0
2,KECAMATAN,33151,AJIBARANG,0,0,0
2,KECAMATAN,33140,PURWOJATI,0,0,0
2,KECAMATAN,32998,WANGON,0,0,0
2,KECAMATAN,33011,JATILAWANG,0,0,0
2,KECAMATAN,33023,RAWALO,0,0,0
2,KECAMATAN,33033,KEBASEN,0,0,0
2,KECAMATAN,33046,KEMRANJEN,0,0,0
2,KECAMATAN,33062,SUMPIUH,0,0,0
2,KECAMATAN,33077,TAMBAK,0,0,0
2,KECAMATAN,33090,SOMAGEDE,0,0,0
2,KECAMATAN,33100,KALIBAGOR,0,0,0
2,KECAMATAN,33113,BANYUMAS,0,0,0
2,KECAMATAN,33126,PATIKRAJA,0,0,0
2,KECAMATAN,33337,PURWOKERTO UTARA,0,0,0
1,KABUPATEN/KOTA,33345,PURBALINGGA,0,0,0
2,KECAMATAN,33346,KEMANGKON,13931,19774,33705
2,KECAMATAN,33584,KARANGJAMBU,3463,9131,12594
2,KECAMATAN,33574,PENGADEGAN,5974,14530,20504
2,KECAMATAN,33559,PADAMARA,9478,14890,24368
2,KECAMATAN,33545,BOJONGSARI,12041,20961,33002
2,KECAMATAN,33532,REMBANG,8720,23459,32179
2,KECAMATAN,33520,KARANGMONCOL,9902,17958,27860
2,KECAMATAN,33506,KARANGANYAR,6964,11818,18782
2,KECAMATAN,33498,KARANGREJA,7491,14615,22106
2,KECAMATAN,33481,BOBOTSARI,12439,15550,27989
2,KECAMATAN,33461,MREBET,13984,24042,38026
2,KECAMATAN,33446,KUTASARI,11227,21440,32667
2,KECAMATAN,33428,KALIMANAH,12142,19189,31331
2,KECAMATAN,33414,PURBALINGGA,15054,18887,33941
2,KECAMATAN,33395,KALIGONDANG,12111,22273,34384
2,KECAMATAN,33381,KEJOBONG,7690,17272,24962
2,KECAMATAN,33366,BUKATEJA,14990,24535,39525
2,KECAMATAN,33591,KERTANEGARA,6272,10380,16652
1,KABUPATEN/KOTA,33603,BANJARNEGARA,183873,320704,504577
2,KECAMATAN,33604,SUSUKAN,8424,21251,29675
2,KECAMATAN,33772,PUNGGELAN,0,0,0
2,KECAMATAN,33790,KARANGKOBAR,0,0,0
2,KECAMATAN,33804,PAGENTAN,9118,11668,20786
2,KECAMATAN,33821,PEJAWARAN,0,0,0
2,KECAMATAN,33839,BATUR,0,0,0
2,KECAMATAN,33848,WANAYASA,11278,15366,26644
2,KECAMATAN,33866,KALIBENING,8477,14232,22709
2,KECAMATAN,33883,PANDANARUM,0,0,0
2,KECAMATAN,33760,RAKIT,11091,16787,27878
2,KECAMATAN,33748,WANADADI,0,0,0
2,KECAMATAN,33620,PURWOREJO KLAMPOK,0,0,0
2,KECAMATAN,33629,MANDIRAJA,0,0,0
2,KECAMATAN,33646,PURWONEGORO,0,0,0
2,KECAMATAN,33660,BAWANG,13130,19371,32501
2,KECAMATAN,33679,BANJARNEGARA,0,0,0
2,KECAMATAN,33693,SIGALUH,0,0,0
2,KECAMATAN,33709,MADUKARA,0,0,0
2,KECAMATAN,33730,BANJARMANGU,0,0,0
2,KECAMATAN,33892,PAGEDONGAN,5590,13914,19504
1,KABUPATEN/KOTA,33902,KEBUMEN,67108,112589,179697
2,KECAMATAN,33903,AYAH,10641,23694,34335
2,KECAMATAN,34209,ADIMULYO,9066,11729,20795
2,KECAMATAN,34233,KUWARASAN,10067,15930,25997
2,KECAMATAN,34256,ROWOKELE,8509,15511,24020
2,KECAMATAN,34268,SEMPOR,10001,22363,32364
2,KECAMATAN,34285,GOMBONG,12332,15076,27408
2,KECAMATAN,34300,KARANGANYAR,7625,11814,19439
2,KECAMATAN,34312,KARANGGAYAM,6107,20798,26905
2,KECAMATAN,34332,SADANG,2220,6951,9171
2,KECAMATAN,34340,BONOROWO,5504,5349,10853
2,KECAMATAN,34352,PADURESO,3261,4863,8124
2,KECAMATAN,34362,PONCOWARNO,3246,5397,8643
2,KECAMATAN,34187,SRUWENG,10424,19320,29744
2,KECAMATAN,34173,PEJAGOAN,10655,16232,26887
2,KECAMATAN,33922,BUAYAN,8410,22801,31211
2,KECAMATAN,33943,PURING,10742,20932,31674
2,KECAMATAN,33967,PETANAHAN,12904,19186,32090
2,KECAMATAN,33989,KLIRONG,13143,20913,34056
2,KECAMATAN,34014,BULUSPESANTREN,13136,17686,30822
2,KECAMATAN,34036,AMBAL,12297,20296,32593
2,KECAMATAN,34069,MIRIT,10378,15578,25956
2,KECAMATAN,34092,PREMBUN,6738,8532,15270
2,KECAMATAN,34106,KUTOWINANGUN,11153,14001,25154
2,KECAMATAN,34126,ALIAN,11453,17734,29187
2,KECAMATAN,34143,KEBUMEN,30788,36174,66962
2,KECAMATAN,34374,KARANGSAMBUNG,6506,13853,20359
1,KABUPATEN/KOTA,34389,PURWOREJO,257306,422713,680019
2,KECAMATAN,34390,GRABAG,0,0,0
2,KECAMATAN,34849,LOANO,0,0,0
2,KECAMATAN,34823,GEBANG,0,0,0
2,KECAMATAN,34804,BRUNO,0,0,0
2,KECAMATAN,34763,KEMIRI,0,0,0
2,KECAMATAN,34713,PITURUH,0,0,0
2,KECAMATAN,34671,BUTUH,0,0,0
2,KECAMATAN,34643,KUTOARJO,0,0,0
2,KECAMATAN,34616,BAYAN,0,0,0
2,KECAMATAN,34588,BANYU URIP,0,0,0
2,KECAMATAN,34562,PURWOREJO,0,0,0
2,KECAMATAN,34540,KALIGESING,0,0,0
2,KECAMATAN,34522,BAGELEN,0,0,0
2,KECAMATAN,34481,PURWODADI,0,0,0
2,KECAMATAN,34423,NGOMBOL,0,0,0
2,KECAMATAN,34871,BENER,0,0,0
1,KABUPATEN/KOTA,34900,WONOSOBO,0,0,0
2,KECAMATAN,34901,WADASLINTANG,0,0,0
2,KECAMATAN,35154,SUKOHARJO,0,0,0
2,KECAMATAN,35137,KEJAJAR,0,0,0
2,KECAMATAN,35121,GARUNG,0,0,0
2,KECAMATAN,35101,MOJOTENGAH,0,0,0
2,KECAMATAN,35084,WATUMALANG,0,0,0
2,KECAMATAN,35063,WONOSOBO,0,0,0
2,KECAMATAN,35041,KERTEK,0,0,0
2,KECAMATAN,35021,KALIKAJAR,0,0,0
2,KECAMATAN,34996,SELOMERTO,0,0,0
2,KECAMATAN,34981,LEKSONO,0,0,0
2,KECAMATAN,34959,KALIWIRO,0,0,0
2,KECAMATAN,34941,SAPURAN,0,0,0
2,KECAMATAN,34919,KEPIL,0,0,0
2,KECAMATAN,35172,KALIBAWANG,0,0,0
1,KABUPATEN/KOTA,35181,MAGELANG,0,0,0
2,KECAMATAN,35182,SALAMAN,17373,23159,40532
2,KECAMATAN,35388,KALIANGKRIK,15494,15799,31293
2,KECAMATAN,35409,BANDONGAN,17942,15428,33370
2,KECAMATAN,35424,CANDIMULYO,11691,17803,29494
2,KECAMATAN,35444,PAKIS,12748,22325,35073
2,KECAMATAN,35465,NGABLAK,9563,17025,26588
2,KECAMATAN,35482,GRABAG,19900,32681,52581
2,KECAMATAN,35511,TEGALREJO,13883,18847,32730
2,KECAMATAN,35533,SECANG,20741,24914,45655
2,KECAMATAN,35358,KAJORAN,13389,18419,31808
2,KECAMATAN,35342,TEMPURAN,12774,15842,28616
2,KECAMATAN,35328,MERTOYUDAN,33186,30995,64181
2,KECAMATAN,35203,BOROBUDUR,15105,21472,36577
2,KECAMATAN,35224,NGLUWAR,9337,10753,20090
2,KECAMATAN,35233,SALAM,13752,14992,28744
2,KECAMATAN,35246,SRUMBUNG,16696,13113,29809
2,KECAMATAN,35264,DUKUN,14303,14673,28976
2,KECAMATAN,35280,SAWANGAN,17488,18322,35810
2,KECAMATAN,35296,MUNTILAN,22031,26459,48490
2,KECAMATAN,35311,MUNGKID,24554,19692,44246
2,KECAMATAN,35554,WINDUSARI,13455,14745,28200
1,KABUPATEN/KOTA,35575,BOYOLALI,345405,407458,752863
2,KECAMATAN,35576,SELO,0,0,0
2,KECAMATAN,35832,WONOSEGORO,0,0,0
2,KECAMATAN,35818,KEMUSU,0,0,0
2,KECAMATAN,35801,ANDONG,0,0,0
2,KECAMATAN,35787,KLEGO,0,0,0
2,KECAMATAN,35770,KARANGGEDE,0,0,0
2,KECAMATAN,35756,SIMO,0,0,0
2,KECAMATAN,35742,NOGOSARI,0,0,0
2,KECAMATAN,35729,NGEMPLAK,0,0,0
2,KECAMATAN,35712,SAMBI,0,0,0
2,KECAMATAN,35696,BANYUDONO,0,0,0
2,KECAMATAN,35683,SAWIT,0,0,0
2,KECAMATAN,35669,TERAS,0,0,0
2,KECAMATAN,35655,MOJOSONGO,0,0,0
2,KECAMATAN,35645,BOYOLALI,0,0,0
2,KECAMATAN,35624,MUSUK,0,0,0
2,KECAMATAN,35608,CEPOGO,0,0,0
2,KECAMATAN,35587,AMPEL,0,0,0
2,KECAMATAN,35851,JUWANGI,0,0,0
1,KABUPATEN/KOTA,35862,KLATEN,0,0,0
2,KECAMATAN,35863,PRAMBANAN,9270,21236,30506
2,KECAMATAN,36109,WONOSARI,8479,29319,37798
2,KECAMATAN,36128,DELANGGU,7808,18067,25875
2,KECAMATAN,36145,POLANHARJO,6885,17727,24612
2,KECAMATAN,36164,KARANGANOM,8006,19403,27409
2,KECAMATAN,36184,TULUNG,8231,22597,30828
2,KECAMATAN,36203,JATINOM,10251,24032,34283
2,KECAMATAN,36222,KEMALANG,4732,17473,22205
2,KECAMATAN,36236,NGAWEN,9630,17000,26630
2,KECAMATAN,36250,KALIKOTES,4765,15657,20422
2,KECAMATAN,36258,KLATEN UTARA,8653,19462,28115
2,KECAMATAN,36267,KLATEN TENGAH,6523,18523,25046
2,KECAMATAN,36089,JUWIRING,8739,26529,35268
2,KECAMATAN,36069,KARANGDOWO,6134,20527,26661
2,KECAMATAN,35880,GANTIWARNO,5769,17131,22900
2,KECAMATAN,35897,WEDI,7174,22879,30053
2,KECAMATAN,35917,BAYAT,6099,29007,35106
2,KECAMATAN,35936,CAWAS,6257,28114,34371
2,KECAMATAN,35957,TRUCUK,10171,35820,45991
2,KECAMATAN,35976,KEBONARUM,3429,8561,11990
2,KECAMATAN,35984,JOGONALAN,7895,26771,34666
2,KECAMATAN,36003,MANISRENGGO,6896,19169,26065
2,KECAMATAN,36020,KARANGNONGKO,5401,16492,21893
2,KECAMATAN,36035,CEPER,9106,29853,38959
2,KECAMATAN,36054,PEDAN,5420,23192,28612
2,KECAMATAN,36277,KLATEN SELATAN,7312,18090,25402
1,KABUPATEN/KOTA,36290,SUKOHARJO,189035,562631,751666
2,KECAMATAN,36291,WERU,0,0,0
2,KECAMATAN,36442,GATAK,0,0,0
2,KECAMATAN,36427,BAKI,0,0,0
2,KECAMATAN,36412,GROGOL,0,0,0
2,KECAMATAN,36396,MOJOLABAN,0,0,0
2,KECAMATAN,36378,POLOKARTO,0,0,0
2,KECAMATAN,36363,BENDOSARI,0,0,0
2,KECAMATAN,36346,NGUTER,0,0,0
2,KECAMATAN,36331,SUKOHARJO,0,0,0
2,KECAMATAN,36318,TAWANGSARI,0,0,0
2,KECAMATAN,36305,BULU,0,0,0
2,KECAMATAN,36457,KARTASURA,0,0,0
1,KABUPATEN/KOTA,36470,WONOGIRI,0,0,0
2,KECAMATAN,36471,PRACIMANTORO,0,0,0
2,KECAMATAN,36651,JATIROTO,0,0,0
2,KECAMATAN,36667,KISMANTORO,0,0,0
2,KECAMATAN,36678,PURWANTORO,0,0,0
2,KECAMATAN,36694,BULUKERTO,0,0,0
2,KECAMATAN,36705,SLOGOHIMO,0,0,0
2,KECAMATAN,36723,JATISRONO,0,0,0
2,KECAMATAN,36741,JATIPURNO,0,0,0
2,KECAMATAN,36753,GIRIMARTO,0,0,0
2,KECAMATAN,36768,KARANGTENGAH,0,0,0
2,KECAMATAN,36774,PARANGGUPITO,0,0,0
2,KECAMATAN,36638,SIDOARJO,0,0,0
2,KECAMATAN,36626,NGADIROJO,0,0,0
2,KECAMATAN,36610,WONOGIRI,0,0,0
2,KECAMATAN,36490,GIRITONTRO,0,0,0
2,KECAMATAN,36498,GIRIWOYO,0,0,0
2,KECAMATAN,36515,BATUWARNO,0,0,0
2,KECAMATAN,36524,TIRTOMOYO,0,0,0
2,KECAMATAN,36539,NGUNTORONADI,0,0,0
2,KECAMATAN,36551,BATURETNO,0,0,0
2,KECAMATAN,36565,EROMOKO,0,0,0
2,KECAMATAN,36581,WURYANTORO,0,0,0
2,KECAMATAN,36590,MANYARAN,0,0,0
2,KECAMATAN,36598,SELOGIRI,0,0,0
2,KECAMATAN,36783,PUHPELEM,0,0,0
1,KABUPATEN/KOTA,36790,KARANGANYAR,0,0,0
2,KECAMATAN,36791,JATIPURO,5041,15091,20132
2,KECAMATAN,36964,KERJO,5938,15807,21745
2,KECAMATAN,36950,MOJOGEDANG,10628,28389,39017
2,KECAMATAN,36939,KEBAKKRAMAT,11593,27950,39543
2,KECAMATAN,36925,GONDANGREJO,9237,37052,46289
2,KECAMATAN,36913,COLOMADU,9659,29553,39212
2,KECAMATAN,36904,JATEN,14067,35499,49566
2,KECAMATAN,36893,TASIKMADU,12679,24697,37376
2,KECAMATAN,36880,KARANGANYAR,15636,33038,48674
2,KECAMATAN,36868,KARANGPANDAN,6132,19212,25344
2,KECAMATAN,36858,NGARGOYOSO,5936,15203,21139
2,KECAMATAN,36847,TAWANGMANGU,7771,19101,26872
2,KECAMATAN,36837,MATESIH,8547,17353,25900
2,KECAMATAN,36825,JUMANTONO,7001,20883,27884
2,KECAMATAN,36812,JUMAPOLO,5192,18740,23932
2,KECAMATAN,36802,JATIYOSO,5870,18143,24013
2,KECAMATAN,36975,JENAWI,4628,11445,16073
1,KABUPATEN/KOTA,36985,SRAGEN,145555,387156,532711
2,KECAMATAN,36986,KALIJAMBE,0,0,0
2,KECAMATAN,37115,TANON,0,0,0
2,KECAMATAN,37132,GEMOLONG,0,0,0
2,KECAMATAN,37147,MIRI,0,0,0
2,KECAMATAN,37158,SUMBERLAWANG,0,0,0
2,KECAMATAN,37170,MONDOKAN,0,0,0
2,KECAMATAN,37180,SUKODONO,0,0,0
2,KECAMATAN,37190,GESI,0,0,0
2,KECAMATAN,37198,TANGEN,0,0,0
2,KECAMATAN,37102,SIDOHARJO,0,0,0
2,KECAMATAN,37093,SRAGEN,0,0,0
2,KECAMATAN,37001,PLUPUH,0,0,0
2,KECAMATAN,37018,MASARAN,0,0,0
2,KECAMATAN,37032,KEDAWUNG,0,0,0
2,KECAMATAN,37043,SAMBIREJO,0,0,0
2,KECAMATAN,37053,GONDANG,0,0,0
2,KECAMATAN,37063,SAMBUNGMACAN,0,0,0
2,KECAMATAN,37073,NGRAMPAL,0,0,0
2,KECAMATAN,37082,KARANGMALANG,0,0,0
2,KECAMATAN,37206,JENAR,0,0,0
1,KABUPATEN/KOTA,37214,GROBOGAN,0,0,0
2,KECAMATAN,37215,KEDUNGJATI,7492,14829,22321
2,KECAMATAN,37485,TEGOWANU,0,0,0
2,KECAMATAN,37463,GUBUG,14325,26451,40776
2,KECAMATAN,37434,GODONG,13901,28913,42814
2,KECAMATAN,37424,KLAMBU,5873,13065,18938
2,KECAMATAN,37414,BRATI,6648,18786,25434
2,KECAMATAN,37396,PURWODADI,21586,50862,72448
2,KECAMATAN,37383,GROBOGAN,0,0,0
2,KECAMATAN,37372,TAWANGHARJO,6580,20819,27399
2,KECAMATAN,37357,WIROSARI,12161,36063,48224
2,KECAMATAN,37344,NGARINGAN,9803,26044,35847
2,KECAMATAN,37329,GABUS,7148,31642,38790
2,KECAMATAN,37314,KRADENAN,0,0,0
2,KECAMATAN,37300,PULOKULON,11612,42594,54206
2,KECAMATAN,37286,GEYER,7805,28142,35947
2,KECAMATAN,37269,TOROH,13613,45775,59388
2,KECAMATAN,37248,PENAWANGAN,0,0,0
2,KECAMATAN,37228,KARANGRAYUNG,9705,36188,45893
2,KECAMATAN,37504,TANGGUNGHARJO,5959,15222,21181
1,KABUPATEN/KOTA,37514,BLORA,154211,435395,589606
2,KECAMATAN,37515,JATI,7985,20211,28196
2,KECAMATAN,37792,BOGOREJO,4608,10353,14961
2,KECAMATAN,37766,TODANAN,8624,28624,37248
2,KECAMATAN,37739,KUNDURAN,10510,26782,37292
2,KECAMATAN,37709,NGAWEN,9861,22473,32334
2,KECAMATAN,37688,BANJAREJO,9915,23146,33061
2,KECAMATAN,37672,TUNJUNGAN,8613,17922,26535
2,KECAMATAN,37643,BLORA,17306,36975,54281
2,KECAMATAN,37617,JEPON,11059,25040,36099
2,KECAMATAN,37605,JIKEN,8277,14033,22310
2,KECAMATAN,37594,SAMBONG,6789,9135,15924
2,KECAMATAN,37576,CEPU,17183,26112,43295
2,KECAMATAN,37558,KEDUNGTUBAN,12561,19001,31562
2,KECAMATAN,37547,KRADENAN,8749,14372,23121
2,KECAMATAN,37528,RANDUBLATUNG,17055,26235,43290
2,KECAMATAN,37807,JAPAH,5611,14762,20373
1,KABUPATEN/KOTA,37826,REMBANG,164706,335176,499882
2,KECAMATAN,37827,SUMBER,5634,16868,22502
2,KECAMATAN,38100,SLUKE,4362,11608,15970
2,KECAMATAN,38072,KRAGAN,10997,27224,38221
2,KECAMATAN,38048,PANCUR,6739,10696,17435
2,KECAMATAN,38012,REMBANG,16407,36968,53375
2,KECAMATAN,37988,KALIORI,5943,19617,25560
2,KECAMATAN,37966,SULANG,6463,17008,23471
2,KECAMATAN,37942,PAMOTAN,10768,16246,27014
2,KECAMATAN,37920,SEDAN,14521,15279,29800
2,KECAMATAN,37896,SARANG,18747,18177,36924
2,KECAMATAN,37880,SALE,7307,14943,22250
2,KECAMATAN,37863,GUNEM,4882,9641,14523
2,KECAMATAN,37846,BULU,4549,12279,16828
2,KECAMATAN,38115,LASEM,9135,18839,27974
1,KABUPATEN/KOTA,38136,PATI,126454,245393,371847
2,KECAMATAN,38137,SUKOLILO,0,0,0
2,KECAMATAN,38412,GEMBONG,0,0,0
2,KECAMATAN,38424,TLOGOWUNGU,0,0,0
2,KECAMATAN,38440,WEDARIJAKSA,0,0,0
2,KECAMATAN,38459,MARGOYOSO,0,0,0
2,KECAMATAN,38482,GUNUNGWUNGKAL,0,0,0
2,KECAMATAN,38498,CLUWAK,0,0,0
2,KECAMATAN,38512,TAYU,0,0,0
2,KECAMATAN,38534,DUKUHSETI,0,0,0
2,KECAMATAN,38393,MARGOREJO,0,0,0
2,KECAMATAN,38368,GABUS,0,0,0
2,KECAMATAN,38338,PATI,0,0,0
2,KECAMATAN,38154,KAYEN,0,0,0
2,KECAMATAN,38172,TAMBAKROMO,0,0,0
2,KECAMATAN,38191,WINONG,0,0,0
2,KECAMATAN,38222,PUCAKWANGI,0,0,0
2,KECAMATAN,38243,JAKEN,0,0,0
2,KECAMATAN,38265,BATANGAN,0,0,0
2,KECAMATAN,38284,JUWANA,0,0,0
2,KECAMATAN,38314,JAKENAN,0,0,0
2,KECAMATAN,38547,TRANGKIL,0,0,0
1,KABUPATEN/KOTA,38564,KUDUS,0,0,0
2,KECAMATAN,38565,KALIWUNGU,23864,27994,51858
2,KECAMATAN,38581,KUDUS,22734,31777,54511
2,KECAMATAN,38607,JATI,26868,33698,60566
2,KECAMATAN,38622,UNDAAN,16934,23930,40864
2,KECAMATAN,38639,MEJOBO,18295,24893,43188
2,KECAMATAN,38651,JEKULO,28108,31031,59139
2,KECAMATAN,38664,BAE,18224,20862,39086
2,KECAMATAN,38675,GEBOG,20288,30483,50771
2,KECAMATAN,38687,DAWE,19856,35716,55572
1,KABUPATEN/KOTA,38706,JEPARA,195171,260384,455555
2,KECAMATAN,38707,KEDUNG,11714,25211,36925
2,KECAMATAN,38899,DONOROJO,8575,23119,31694
2,KECAMATAN,38887,KEMBANG,9721,29304,39025
2,KECAMATAN,38874,KALINYAMATAN,13022,19165,32187
2,KECAMATAN,38858,NALUMSARI,11362,23815,35177
2,KECAMATAN,38842,TAHUNAN,13514,44946,58460
2,KECAMATAN,38838,KARIMUN JAWA,988,3728,4716
2,KECAMATAN,38825,KELING,8011,27254,35265
2,KECAMATAN,38812,BANGSRI,12216,39188,51404
2,KECAMATAN,38803,MLONGGO,12133,30670,42803
2,KECAMATAN,38786,JEPARA,12818,31196,44014
2,KECAMATAN,38774,BATEALIT,14389,29415,43804
2,KECAMATAN,38755,MAYONG,15329,31047,46376
2,KECAMATAN,38739,WELAHAN,13474,27142,40616
2,KECAMATAN,38726,PECANGAAN,15351,28816,44167
2,KECAMATAN,38908,PAKIS AJI,8124,22394,30518
1,KABUPATEN/KOTA,38917,DEMAK,180741,436410,617151
2,KECAMATAN,38918,MRANGGEN,33483,53744,87227
2,KECAMATAN,39145,WEDUNG,13575,23916,37491
2,KECAMATAN,39123,BONANG,17262,31864,49126
2,KECAMATAN,39103,DEMAK,23527,34470,57997
2,KECAMATAN,39087,MIJEN,7974,19891,27865
2,KECAMATAN,39069,KARANGANYAR,12057,24775,36832
2,KECAMATAN,39050,GAJAH,10882,15342,26224
2,KECAMATAN,39033,DEMPET,11194,18571,29765
2,KECAMATAN,39011,WONOSALAM,13927,26713,40640
2,KECAMATAN,38993,KARANGTENGAH,11281,21573,32854
2,KECAMATAN,38972,SAYUNG,23464,32286,55750
2,KECAMATAN,38951,GUNTUR,16180,25048,41228
2,KECAMATAN,38938,KARANGAWEN,21766,28299,50065
2,KECAMATAN,39166,KEBONAGUNG,7504,13234,20738
1,KABUPATEN/KOTA,39181,SEMARANG,224076,369726,593802
2,KECAMATAN,39182,GETASAN,10042,22729,32771
2,KECAMATAN,39414,UNGARAN TIMUR,18054,22367,40421
2,KECAMATAN,39402,UNGARAN BARAT,0,0,0
2,KECAMATAN,39390,KALIWUNGU,4651,13254,17905
2,KECAMATAN,39380,BANCAK,0,0,0
2,KECAMATAN,39370,PRINGAPUS,11579,17931,29510
2,KECAMATAN,39356,BERGAS,17081,22598,39679
2,KECAMATAN,39339,BRINGIN,10165,15684,25849
2,KECAMATAN,39329,BAWEN,12609,20824,33433
2,KECAMATAN,39318,AMBARAWA,11319,26255,37574
2,KECAMATAN,39301,SUMOWONO,8657,10658,19315
2,KECAMATAN,39290,JAMBU,9185,15169,24354
2,KECAMATAN,39279,BANYUBIRU,10196,15343,25539
2,KECAMATAN,39262,TUNTANG,14732,24114,38846
2,KECAMATAN,39244,PABELAN,0,0,0
2,KECAMATAN,39226,SURUH,15181,22460,37641
2,KECAMATAN,39212,SUSUKAN,10269,16543,26812
2,KECAMATAN,39196,TENGARAN,16397,24177,40574
2,KECAMATAN,39425,BANDUNGAN,13504,20685,34189
1,KABUPATEN/KOTA,39436,TEMANGGUNG,193621,310791,504412
2,KECAMATAN,39437,BULU,10895,19248,30143
2,KECAMATAN,39623,CANDIROTO,6064,14113,20177
2,KECAMATAN,39638,KRANGGAN,10216,18722,28938
2,KECAMATAN,39652,TLOGOMULYO,3440,11397,14837
2,KECAMATAN,39665,SELOPAMPANG,5737,6112,11849
2,KECAMATAN,39678,BANSARI,2509,13190,15699
2,KECAMATAN,39692,KLEDUNG,4990,11960,16950
2,KECAMATAN,39706,BEJEN,4610,8161,12771
2,KECAMATAN,39721,WONOBOYO,6252,9757,16009
2,KECAMATAN,39611,TRETEP,3881,9132,13013
2,KECAMATAN,39597,JUMO,5997,12856,18853
2,KECAMATAN,39457,TEMBARAK,6729,11013,17742
2,KECAMATAN,39471,TEMANGGUNG,20538,28791,49329
2,KECAMATAN,39497,PRINGSURAT,11300,19903,31203
2,KECAMATAN,39512,KALORAN,9958,17319,27277
2,KECAMATAN,39527,KANDANGAN,11985,18354,30339
2,KECAMATAN,39544,KEDU,14170,20595,34765
2,KECAMATAN,39559,PARAKAN,11289,20857,32146
2,KECAMATAN,39576,NGADIREJO,8857,25266,34123
2,KECAMATAN,39735,GEMAWANG,7795,12372,20167
1,KABUPATEN/KOTA,39746,KENDAL,167212,309118,476330
2,KECAMATAN,39747,PLANTUNGAN,0,0,0
2,KECAMATAN,39912,WELERI,0,0,0
2,KECAMATAN,39929,CEPIRING,0,0,0
2,KECAMATAN,39945,PATEBON,0,0,0
2,KECAMATAN,39964,KENDAL,0,0,0
2,KECAMATAN,39985,ROWOSARI,0,0,0
2,KECAMATAN,40002,KANGKUNG,0,0,0
2,KECAMATAN,40018,RINGINARUM,0,0,0
2,KECAMATAN,40031,NGAMPEL,0,0,0
2,KECAMATAN,39895,GEMUH,0,0,0
2,KECAMATAN,39882,PEGANDON,0,0,0
2,KECAMATAN,39760,PAGERUYUNG,0,0,0
2,KECAMATAN,39775,SUKOREJO,0,0,0
2,KECAMATAN,39794,PATEAN,0,0,0
2,KECAMATAN,39809,SINGOROJO,0,0,0
2,KECAMATAN,39823,LIMBANGAN,0,0,0
2,KECAMATAN,39840,BOJA,0,0,0
2,KECAMATAN,39859,KALIWUNGU,0,0,0
2,KECAMATAN,39869,BRANGSONG,0,0,0
2,KECAMATAN,40044,KALIWUNGU SELATAN,0,0,0
1,KABUPATEN/KOTA,40053,BATANG,0,0,0
2,KECAMATAN,40054,WONOTUNGGAL,7244,11974,19218
2,KECAMATAN,40294,PECALUNGAN,6124,11138,17262
2,KECAMATAN,40280,KANDEMAN,7706,19191,26897
2,KECAMATAN,40261,WARUNGASEM,8196,19604,27800
2,KECAMATAN,40239,BATANG,26277,46083,72360
2,KECAMATAN,40221,TULIS,6546,14175,20721
2,KECAMATAN,40203,SUBAH,9782,21225,31007
2,KECAMATAN,40185,LIMPUNG,8581,16141,24722
2,KECAMATAN,40169,GRINGSING,11492,22122,33614
2,KECAMATAN,40148,TERSONO,9443,13338,22781
2,KECAMATAN,40127,BAWANG,9845,19271,29116
2,KECAMATAN,40107,REBAN,7790,13289,21079
2,KECAMATAN,40088,BLADO,8343,14243,22586
2,KECAMATAN,40070,BANDAR,11790,22628,34418
2,KECAMATAN,40305,BANYUPUTIH,5860,14284,20144
1,KABUPATEN/KOTA,40317,PEKALONGAN,145019,278706,423725
2,KECAMATAN,40318,KANDANGSERANG,0,0,0
2,KECAMATAN,40598,KARANGDADAP,5066,14802,19868
2,KECAMATAN,40584,SIWALAN,0,0,0
2,KECAMATAN,40567,WIRADESA,11949,20788,32737
2,KECAMATAN,40550,TIRTO,10309,27694,38003
2,KECAMATAN,40539,BUARAN,0,0,0
2,KECAMATAN,40519,KEDUNGWUNI,0,0,0
2,KECAMATAN,40504,WONOPRINGGO,0,0,0
2,KECAMATAN,40481,BOJONG,0,0,0
2,KECAMATAN,40463,SRAGI,9207,23629,32836
2,KECAMATAN,40439,KESESI,0,0,0
2,KECAMATAN,40413,KAJEN,0,0,0
2,KECAMATAN,40397,KARANGANYAR,7534,13819,21353
2,KECAMATAN,40382,DORO,0,0,0
2,KECAMATAN,40371,TALUN,4520,10028,14548
2,KECAMATAN,40361,PETUNGKRIYONO,2105,4886,6991
2,KECAMATAN,40349,LEBAKBARANG,0,0,0
2,KECAMATAN,40333,PANINGGARAN,6528,11584,18112
2,KECAMATAN,40610,WONOKERTO,5019,17005,22024
1,KABUPATEN/KOTA,40622,PEMALANG,62237,144235,206472
2,KECAMATAN,40623,MOGA,16932,13775,30707
2,KECAMATAN,40833,ULUJAMI,14131,42849,56980
2,KECAMATAN,40814,COMAL,14910,33516,48426
2,KECAMATAN,40797,AMPELGADING,10478,24394,34872
2,KECAMATAN,40776,PETARUKAN,24473,54920,79393
2,KECAMATAN,40754,TAMAN,30608,55755,86363
2,KECAMATAN,40733,PEMALANG,36843,61976,98819
2,KECAMATAN,40714,RANDUDONGKAL,20286,30936,51222
2,KECAMATAN,40696,BANTARBOLANG,11943,25472,37415
2,KECAMATAN,40676,BODEH,9093,20539,29632
2,KECAMATAN,40660,WATUKUMPUL,9018,24996,34014
2,KECAMATAN,40647,BELIK,15217,36218,51435
2,KECAMATAN,40634,PULOSARI,13131,15417,28548
2,KECAMATAN,40852,WARUNGPRING,5630,12705,18335
1,KABUPATEN/KOTA,40859,TEGAL,232693,453468,686161
2,KECAMATAN,40860,MARGASARI,0,0,0
2,KECAMATAN,41141,WARUREJA,0,0,0
2,KECAMATAN,41129,SURADADI,0,0,0
2,KECAMATAN,41108,KRAMAT,0,0,0
2,KECAMATAN,41087,TARUB,0,0,0
2,KECAMATAN,41068,DUKUHTURI,0,0,0
2,KECAMATAN,41048,TALANG,0,0,0
2,KECAMATAN,41026,ADIWERNA,0,0,0
2,KECAMATAN,41015,SLAWI,0,0,0
2,KECAMATAN,40991,PANGKAH,0,0,0
2,KECAMATAN,40980,KEDUNGBANTENG,0,0,0
2,KECAMATAN,40962,JATINEGARA,0,0,0
2,KECAMATAN,40946,LEBAKSIU,0,0,0
2,KECAMATAN,40932,PAGERBARANG,0,0,0
2,KECAMATAN,40911,BALAPULANG,0,0,0
2,KECAMATAN,40893,BOJONG,0,0,0
2,KECAMATAN,40874,BUMIJAWA,0,0,0
2,KECAMATAN,41154,DUKUHWARU,0,0,0
1,KABUPATEN/KOTA,41165,BREBES,0,0,0
2,KECAMATAN,41166,SALEM,14237,18963,33200
2,KECAMATAN,41432,KETANGGUNGAN,26046,42651,68697
2,KECAMATAN,41420,LARANGAN,22164,56845,79009
2,KECAMATAN,41400,BULAKAMBA,0,0,0
2,KECAMATAN,41381,TANJUNG,12520,35281,47801
2,KECAMATAN,41358,LOSARI,19741,44362,64103
2,KECAMATAN,41344,KERSANA,10020,23549,33569
2,KECAMATAN,41333,SONGGOM,11284,25903,37187
2,KECAMATAN,41309,BREBES,30887,53922,84809
2,KECAMATAN,41288,WANASARI,22596,54137,76733
2,KECAMATAN,41265,JATIBARANG,16384,26810,43194
2,KECAMATAN,41250,TONJONG,16354,16615,32969
2,KECAMATAN,41236,SIRAMPOG,14264,16062,30326
2,KECAMATAN,41223,PAGUYANGAN,0,0,0
2,KECAMATAN,41207,BUMIAYU,24154,29444,53598
2,KECAMATAN,41188,BANTARKAWUNG,19423,28090,47513
2,KECAMATAN,41454,BANJARHARJO,19197,39128,58325
1,KABUPATEN/KOTA,41480,KOTA MAGELANG,279271,511762,791033
2,KECAMATAN,41481,MAGELANG SELATAN,0,0,0
2,KECAMATAN,41488,MAGELANG UTARA,0,0,0
2,KECAMATAN,41494,MAGELANG TENGAH,0,0,0
1,KABUPATEN/KOTA,41501,KOTA SURAKARTA,0,0,0
2,KECAMATAN,41502,LAWEYAN,11424,47610,59034
2,KECAMATAN,41514,SERENGAN,4760,27542,32302
2,KECAMATAN,41522,PASAR KLIWON,9992,40553,50545
2,KECAMATAN,41532,JEBRES,11173,77733,88906
2,KECAMATAN,41544,BANJARSARI,15354,90761,106115
1,KABUPATEN/KOTA,41558,KOTA SALATIGA,52703,284199,336902
2,KECAMATAN,41559,SIDOREJO,10885,19723,30608
2,KECAMATAN,41566,TINGKIR,8620,17114,25734
2,KECAMATAN,41573,ARGOMULYO,9905,16292,26197
2,KECAMATAN,41580,SIDOMUKTI,9218,15535,24753
1,KABUPATEN/KOTA,41585,KOTA SEMARANG,38628,68664,107292
2,KECAMATAN,41586,SEMARANG TENGAH,7745,29858,37603
2,KECAMATAN,41760,NGALIYAN,31692,45356,77048
2,KECAMATAN,41745,MIJEN,15573,19602,35175
2,KECAMATAN,41728,SEMARANG BARAT,0,0,0
2,KECAMATAN,41711,GUNUNGPATI,20928,29560,50488
2,KECAMATAN,41699,BANYUMANIK,28471,49308,77779
2,KECAMATAN,41686,TEMBALANG,28756,63864,92620
2,KECAMATAN,41677,GAJAH MUNGKUR,11294,23001,34295
2,KECAMATAN,41669,CANDISARI,13810,33069,46879
2,KECAMATAN,41658,SEMARANG SELATAN,12467,29157,41624
2,KECAMATAN,41645,PEDURUNGAN,33160,71319,104479
2,KECAMATAN,41631,GENUK,18179,37678,55857
2,KECAMATAN,41623,GAYAM SARI,11293,29708,41001
2,KECAMATAN,41612,SEMARANG TIMUR,9049,34399,43448
2,KECAMATAN,41602,SEMARANG UTARA,16759,53375,70134
2,KECAMATAN,41771,TUGU,8304,9716,18020
1,KABUPATEN/KOTA,41779,KOTA PEKALONGAN,267480,558970,826450
2,KECAMATAN,41780,PEKALONGAN BARAT,20534,31442,51976
2,KECAMATAN,41794,PEKALONGAN TIMUR,15273,21727,37000
2,KECAMATAN,41808,PEKALONGAN UTARA,17342,26262,43604
2,KECAMATAN,41819,PEKALONGAN SELATAN,11589,20383,31972
1,KABUPATEN/KOTA,41831,KOTA TEGAL,64738,99814,164552
2,KECAMATAN,41832,TEGAL BARAT,13286,22593,35879
2,KECAMATAN,41840,TEGAL TIMUR,19531,23428,42959
2,KECAMATAN,41846,TEGAL SELATAN,14964,18810,33774
2,KECAMATAN,41855,MARGADANA,8131,13944,22075
0,PROVINSI,41863,DAERAH ISTIMEWA YOGYAKARTA,0,0,0
1,KABUPATEN/KOTA,41864,KULON PROGO,55912,78775,134687
2,KECAMATAN,41865,TEMON,8037,8308,16345
2,KECAMATAN,41952,SAMIGALUH,7711,9633,17344
2,KECAMATAN,41945,NANGGULAN,9414,9160,18574
2,KECAMATAN,41940,GIRIMULYO,6704,8515,15219
2,KECAMATAN,41934,KOKAP,9084,12178,21262
2,KECAMATAN,41926,PENGASIH,14963,15224,30187
2,KECAMATAN,41917,SENTOLO,14700,15069,29769
2,KECAMATAN,41910,LENDAH,12493,12934,25427
2,KECAMATAN,41902,GALUR,10959,9078,20037
2,KECAMATAN,41890,PANJATAN,11131,11557,22688
2,KECAMATAN,41881,WATES,13880,15035,28915
2,KECAMATAN,41960,KALIBAWANG,8069,10190,18259
1,KABUPATEN/KOTA,41965,BANTUL,127145,136881,264026
2,KECAMATAN,41966,SRANDAKAN,8983,10818,19801
2,KECAMATAN,42048,KASIHAN,29222,35376,64598
2,KECAMATAN,42043,SEWON,27703,34081,61784
2,KECAMATAN,42039,PIYUNGAN,14949,17163,32112
2,KECAMATAN,42033,PLERET,14595,14050,28645
2,KECAMATAN,42024,BANGUNTAPAN,31177,35058,66235
2,KECAMATAN,42017,DLINGO,8570,15742,24312
2,KECAMATAN,42008,IMOGIRI,17068,21086,38154
2,KECAMATAN,42003,JETIS,16802,19291,36093
2,KECAMATAN,41997,BANTUL,18303,21892,40195
2,KECAMATAN,41993,PAJANGAN,11335,10788,22123
2,KECAMATAN,41988,PANDAK,14072,19020,33092
2,KECAMATAN,41984,BAMBANGLIPURO,0,0,0
2,KECAMATAN,41980,PUNDONG,9925,12392,22317
2,KECAMATAN,41974,KRETEK,9583,9976,19559
2,KECAMATAN,41969,SANDEN,11478,9242,20720
2,KECAMATAN,42053,SEDAYU,16185,13078,29263
1,KABUPATEN/KOTA,42058,GUNUNGKIDUL,259950,299053,559003
2,KECAMATAN,42059,WONOSARI,22398,31101,53499
2,KECAMATAN,42209,TANJUNGSARI,8243,10562,18805
2,KECAMATAN,42200,GIRISUBO,5073,10338,15411
2,KECAMATAN,42192,SAPTOSARI,12112,11430,23542
2,KECAMATAN,42184,GEDANGSARI,5959,15997,21956
2,KECAMATAN,42177,NGAWEN,0,0,0
2,KECAMATAN,42166,SEMIN,9097,23175,32272
2,KECAMATAN,42157,RONGKOP,5673,13179,18852
2,KECAMATAN,42145,PONJONG,11529,22255,33784
2,KECAMATAN,42135,KARANGMOJO,11499,21820,33319
2,KECAMATAN,42129,SEMANU,13007,23330,36337
2,KECAMATAN,42123,TEPUS,10484,11824,22308
2,KECAMATAN,42116,PANGGANG,0,0,0
2,KECAMATAN,42108,PALIYAN,9713,9452,19165
2,KECAMATAN,42096,PATUK,0,0,0
2,KECAMATAN,42082,PLAYEN,14709,22005,36714
2,KECAMATAN,42074,NGLIPAR,8779,10825,19604
2,KECAMATAN,42215,PURWOSARI,5972,6697,12669
1,KABUPATEN/KOTA,42221,SLEMAN,154247,243990,398237
2,KECAMATAN,42222,GAMPING,25451,31468,56919
2,KECAMATAN,42313,PAKEM,10709,12803,23512
2,KECAMATAN,42308,TURI,12594,10309,22903
2,KECAMATAN,42299,TEMPEL,18729,14968,33697
2,KECAMATAN,42293,SLEMAN,20163,21812,41975
2,KECAMATAN,42286,NGAGLIK,24966,33453,58419
2,KECAMATAN,42280,NGEMPLAK,0,0,0
2,KECAMATAN,42275,KALASAN,0,0,0
2,KECAMATAN,42268,PRAMBANAN,0,0,0
2,KECAMATAN,42263,BERBAH,0,0,0
2,KECAMATAN,42259,DEPOK,30186,48189,78375
2,KECAMATAN,42253,MLATI,24638,33318,57956
2,KECAMATAN,42247,SEYEGAN,0,0,0
2,KECAMATAN,42241,MINGGIR,10452,10471,20923
2,KECAMATAN,42236,MOYUDAN,13727,8127,21854
2,KECAMATAN,42228,GODEAN,20653,22478,43131
2,KECAMATAN,42319,CANGKRINGAN,0,0,0
1,KABUPATEN/KOTA,42325,KOTA YOGYAKARTA,212268,247396,459664
2,KECAMATAN,42326,TEGALREJO,0,0,0
2,KECAMATAN,42373,UMBULHARJO,0,0,0
2,KECAMATAN,42369,MERGANGSAN,0,0,0
2,KECAMATAN,42366,PAKUALAMAN,0,0,0
2,KECAMATAN,42363,GONDOMANAN,0,0,0
2,KECAMATAN,42359,KRATON,0,0,0
2,KECAMATAN,42355,MANTRIJERON,0,0,0
2,KECAMATAN,42351,WIROBRAJAN,0,0,0
2,KECAMATAN,42348,NGAMPILAN,0,0,0
2,KECAMATAN,42345,GEDONGTENGEN,0,0,0
2,KECAMATAN,42341,DANUREJAN,0,0,0
2,KECAMATAN,42335,GONDOKUSUMAN,0,0,0
2,KECAMATAN,42331,JETIS,0,0,0
2,KECAMATAN,42381,KOTAGEDE,0,0,0
0,PROVINSI,42385,JAWA TIMUR,0,0,0
1,KABUPATEN/KOTA,42386,PACITAN,0,0,0
2,KECAMATAN,42387,DONOROJO,9123,11467,20590
2,KECAMATAN,42540,NGADIROJO,17139,9779,26918
2,KECAMATAN,42523,TULAKAN,26475,16301,42776
2,KECAMATAN,42511,TEGALOMBO,17277,8915,26192
2,KECAMATAN,42502,BANDAR,15693,8153,23846
2,KECAMATAN,42492,NAWANGAN,14975,10887,25862
2,KECAMATAN,42474,ARJOSARI,15613,6540,22153
2,KECAMATAN,42454,KEBONAGUNG,19865,7227,27092
2,KECAMATAN,42428,PACITAN,34407,9916,44323
2,KECAMATAN,42414,PUNUNG,13649,7683,21332
2,KECAMATAN,42400,PRINGKUKU,12521,6407,18928
2,KECAMATAN,42559,SUDIMORO,8628,9057,17685
1,KABUPATEN/KOTA,42570,PONOROGO,205365,112332,317697
2,KECAMATAN,42571,SLAHUNG,14996,14666,29662
2,KECAMATAN,42771,BADEGAN,8115,9204,17319
2,KECAMATAN,42782,SAMPUNG,10632,12323,22955
2,KECAMATAN,42794,SUKOREJO,15545,16161,31706
2,KECAMATAN,42813,BABADAN,14499,24784,39283
2,KECAMATAN,42829,PONOROGO,18820,25393,44213
2,KECAMATAN,42849,JENANGAN,16777,16221,32998
2,KECAMATAN,42867,NGEBEL,5685,6621,12306
2,KECAMATAN,42876,JAMBON,11309,12064,23373
2,KECAMATAN,42754,KAUMAN,12564,12829,25393
2,KECAMATAN,42733,BALONG,0,0,0
2,KECAMATAN,42714,SIMAN,0,0,0
2,KECAMATAN,42594,NGRAYUN,12722,21510,34232
2,KECAMATAN,42606,BUNGKAL,0,0,0
2,KECAMATAN,42626,SAMBIT,9681,11922,21603
2,KECAMATAN,42642,SAWOO,15828,16810,32638
2,KECAMATAN,42657,SOOKO,6203,8336,14539
2,KECAMATAN,42664,PULUNG,0,0,0
2,KECAMATAN,42683,MLARAK,12714,7859,20573
2,KECAMATAN,42699,JETIS,9724,8563,18287
2,KECAMATAN,42890,PUDAK,2970,2712,5682
1,KABUPATEN/KOTA,42897,TRENGGALEK,198784,227978,426762
2,KECAMATAN,42898,PANGGUL,11137,28641,39778
2,KECAMATAN,43046,DURENAN,11930,17569,29499
2,KECAMATAN,43035,POGALAN,11172,18201,29373
2,KECAMATAN,43021,TRENGGALEK,17039,21062,38101
2,KECAMATAN,43009,GANDUSARI,11734,19249,30983
2,KECAMATAN,43000,BENDUNGAN,5583,9649,15232
2,KECAMATAN,42987,WATULIMO,10066,29747,39813
2,KECAMATAN,42979,KAMPAK,5902,16058,21960
2,KECAMATAN,42966,KARANGAN,12466,15590,28056
2,KECAMATAN,42950,TUGU,12137,14949,27086
2,KECAMATAN,42939,DONGKO,7825,25603,33428
2,KECAMATAN,42928,PULE,10538,19744,30282
2,KECAMATAN,42916,MUNJUNGAN,7575,22342,29917
2,KECAMATAN,43061,SURUH,5876,9368,15244
1,KABUPATEN/KOTA,43069,TULUNGAGUNG,140980,267772,408752
2,KECAMATAN,43070,TULUNGAGUNG,14699,23191,37890
2,KECAMATAN,43332,PAKEL,11449,19477,30926
2,KECAMATAN,43313,BANDUNG,9980,17779,27759
2,KECAMATAN,43303,CAMPURDARAT,9374,24051,33425
2,KECAMATAN,43292,BESUKI,7599,13921,21520
2,KECAMATAN,43274,KALIDAWIR,11955,28310,40265
2,KECAMATAN,43257,REJOTANGAN,14204,28079,42283
2,KECAMATAN,43247,PUCANGLABAN,4458,9089,13547
2,KECAMATAN,43228,NGUNUT,13040,32010,45050
2,KECAMATAN,43210,SUMBERGEMPOL,11481,26470,37951
2,KECAMATAN,43189,GONDANG,14908,19048,33956
2,KECAMATAN,43175,KARANGREJO,9904,14804,24708
2,KECAMATAN,43163,SENDANG,10865,16273,27138
2,KECAMATAN,43151,PAGERWOJO,8214,10649,18863
2,KECAMATAN,43137,KAUMAN,11950,18955,30905
2,KECAMATAN,43123,NGANTRU,8797,23505,32302
2,KECAMATAN,43103,KEDUNGWARU,16708,35162,51870
2,KECAMATAN,43085,BOYOLANGU,16835,30131,46966
2,KECAMATAN,43352,TANGGUNGGUNUNG,4552,10578,15130
1,KABUPATEN/KOTA,43360,BLITAR,210972,401482,612454
2,KECAMATAN,43361,WONODADI,0,0,0
2,KECAMATAN,43515,PANGGUNGREJO,0,0,0
2,KECAMATAN,43526,TALUN,0,0,0
2,KECAMATAN,43541,GANDUSARI,0,0,0
2,KECAMATAN,43556,BINANGUN,0,0,0
2,KECAMATAN,43569,WLINGI,0,0,0
2,KECAMATAN,43579,DOKO,0,0,0
2,KECAMATAN,43590,KESAMBEN,0,0,0
2,KECAMATAN,43601,WATES,0,0,0
2,KECAMATAN,43610,SELOREJO,0,0,0
2,KECAMATAN,43503,SUTOJAYAN,0,0,0
2,KECAMATAN,43493,GARUM,0,0,0
2,KECAMATAN,43373,UDANAWU,0,0,0
2,KECAMATAN,43386,SRENGAT,0,0,0
2,KECAMATAN,43402,KADEMANGAN,0,0,0
2,KECAMATAN,43418,BAKUNG,0,0,0
2,KECAMATAN,43430,PONGGOK,0,0,0
2,KECAMATAN,43446,SANANKULON,0,0,0
2,KECAMATAN,43459,WONOTIRTO,0,0,0
2,KECAMATAN,43468,NGLEGOK,0,0,0
2,KECAMATAN,43480,KANIGORO,0,0,0
2,KECAMATAN,43621,SELOPURO,0,0,0
1,KABUPATEN/KOTA,43630,KEDIRI,0,0,0
2,KECAMATAN,43631,SEMEN,0,0,0
2,KECAMATAN,43836,PURWOASRI,0,0,0
2,KECAMATAN,43860,PLEMAHAN,0,0,0
2,KECAMATAN,43878,PARE,0,0,0
2,KECAMATAN,43888,KEPUNG,0,0,0
2,KECAMATAN,43899,KANDANGAN,0,0,0
2,KECAMATAN,43912,TAROKAN,0,0,0
2,KECAMATAN,43923,KUNJANG,0,0,0
2,KECAMATAN,43936,BANYAKAN,0,0,0
2,KECAMATAN,43946,RINGINREJO,0,0,0
2,KECAMATAN,43958,KAYEN KIDUL,0,0,0
2,KECAMATAN,43971,NGASEM,0,0,0
2,KECAMATAN,43818,PAPAR,0,0,0
2,KECAMATAN,43808,GROGOL,0,0,0
2,KECAMATAN,43644,MOJO,0,0,0
2,KECAMATAN,43665,KRAS,0,0,0
2,KECAMATAN,43682,NGADILUWIH,0,0,0
2,KECAMATAN,43699,KANDAT,0,0,0
2,KECAMATAN,43712,WATES,0,0,0
2,KECAMATAN,43724,NGANCAR,0,0,0
2,KECAMATAN,43735,PUNCU,0,0,0
2,KECAMATAN,43744,PLOSOKLATEN,0,0,0
2,KECAMATAN,43760,GURAH,0,0,0
2,KECAMATAN,43782,PAGU,0,0,0
2,KECAMATAN,43796,GAMPENGREJO,0,0,0
2,KECAMATAN,43984,BADAS,0,0,0
1,KABUPATEN/KOTA,43993,MALANG,0,0,0
2,KECAMATAN,43994,DONOMULYO,0,0,0
2,KECAMATAN,44246,PAKISAJI,0,0,0
2,KECAMATAN,44259,NGAJUNG,0,0,0
2,KECAMATAN,44269,WAGIR,0,0,0
2,KECAMATAN,44282,DAU,0,0,0
2,KECAMATAN,44293,KARANG PLOSO,0,0,0
2,KECAMATAN,44303,SINGOSARI,0,0,0
2,KECAMATAN,44321,LAWANG,0,0,0
2,KECAMATAN,44334,PUJON,0,0,0
2,KECAMATAN,44345,NGANTANG,0,0,0
2,KECAMATAN,44359,KASEMBON,0,0,0
2,KECAMATAN,44366,GEDANGAN,0,0,0
2,KECAMATAN,44375,TIRTOYUDO,0,0,0
2,KECAMATAN,44389,KROMENGAN,0,0,0
2,KECAMATAN,44397,WONOSARI,0,0,0
2,KECAMATAN,44230,PAKIS,0,0,0
2,KECAMATAN,44214,JABUNG,0,0,0
2,KECAMATAN,44198,TUMPANG,0,0,0
2,KECAMATAN,44005,PAGAK,0,0,0
2,KECAMATAN,44014,BANTUR,0,0,0
2,KECAMATAN,44025,SUMBERMANJING WETAN,0,0,0
2,KECAMATAN,44041,DAMPIT,0,0,0
2,KECAMATAN,44054,AMPELGADING,0,0,0
2,KECAMATAN,44068,PONCOKUSUMO,0,0,0
2,KECAMATAN,44086,WAJAK,0,0,0
2,KECAMATAN,44100,TUREN,0,0,0
2,KECAMATAN,44118,GONDANGLEGI,0,0,0
2,KECAMATAN,44133,KALIPARE,0,0,0
2,KECAMATAN,44143,SUMBERPUCUNG,0,0,0
2,KECAMATAN,44151,KEPANJEN,0,0,0
2,KECAMATAN,44170,BULULAWANG,0,0,0
2,KECAMATAN,44185,TAJINAN,0,0,0
2,KECAMATAN,44406,PAGELARAN,0,0,0
1,KABUPATEN/KOTA,44417,LUMAJANG,0,0,0
2,KECAMATAN,44418,TEMPURSARI,0,0,0
2,KECAMATAN,44545,GUCIALIT,0,0,0
2,KECAMATAN,44555,PADANG,0,0,0
2,KECAMATAN,44565,SUKODONO,0,0,0
2,KECAMATAN,44576,KEDUNGJAJANG,0,0,0
2,KECAMATAN,44589,JATIROTO,0,0,0
2,KECAMATAN,44596,RANDUAGUNG,0,0,0
2,KECAMATAN,44609,KLAKAH,0,0,0
2,KECAMATAN,44622,RANUYOSO,0,0,0
2,KECAMATAN,44532,SENDURO,0,0,0
2,KECAMATAN,44524,PASRUJAMBE,0,0,0
2,KECAMATAN,44511,LUMAJANG,0,0,0
2,KECAMATAN,44426,PRONOJIWO,0,0,0
2,KECAMATAN,44433,CANDIPURO,0,0,0
2,KECAMATAN,44444,PASIRIAN,0,0,0
2,KECAMATAN,44456,TEMPEH,0,0,0
2,KECAMATAN,44470,KUNIR,0,0,0
2,KECAMATAN,44482,YOSOWILANGUN,0,0,0
2,KECAMATAN,44494,ROWOKANGKUNG,0,0,0
2,KECAMATAN,44502,TEKUNG,0,0,0
2,KECAMATAN,44634,SUMBERSUKO,0,0,0
1,KABUPATEN/KOTA,44643,JEMBER,0,0,0
2,KECAMATAN,44644,JOMBANG,0,0,0
2,KECAMATAN,44794,TEMPUREJO,0,0,0
2,KECAMATAN,44803,KALIWATES,0,0,0
2,KECAMATAN,44811,PATRANG,0,0,0
2,KECAMATAN,44820,SUMBERSARI,0,0,0
2,KECAMATAN,44828,ARJASA,0,0,0
2,KECAMATAN,44835,MUMBULSARI,0,0,0
2,KECAMATAN,44843,PAKUSARI,0,0,0
2,KECAMATAN,44851,JELBUK,0,0,0
2,KECAMATAN,44858,MAYANG,0,0,0
2,KECAMATAN,44866,KALISAT,0,0,0
2,KECAMATAN,44879,LEDOKOMBO,0,0,0
2,KECAMATAN,44890,SUKOWONO,0,0,0
2,KECAMATAN,44903,SILO,0,0,0
2,KECAMATAN,44786,AJUNG,0,0,0
2,KECAMATAN,44777,JENGGAWAH,0,0,0
2,KECAMATAN,44771,SUKORAMBI,0,0,0
2,KECAMATAN,44651,KENCONG,0,0,0
2,KECAMATAN,44657,SUMBERBARU,0,0,0
2,KECAMATAN,44668,GUMUKMAS,0,0,0
2,KECAMATAN,44677,UMBULSARI,0,0,0
2,KECAMATAN,44688,TANGGUL,0,0,0
2,KECAMATAN,44697,SEMBORO,0,0,0
2,KECAMATAN,44704,PUGER,0,0,0
2,KECAMATAN,44717,BANGSALSARI,0,0,0
2,KECAMATAN,44729,BALUNG,0,0,0
2,KECAMATAN,44738,WULUHAN,0,0,0
2,KECAMATAN,44746,AMBULU,0,0,0
2,KECAMATAN,44754,RAMBIPUJI,0,0,0
2,KECAMATAN,44763,PANTI,0,0,0
2,KECAMATAN,44913,SUMBERJAMBE,0,0,0
1,KABUPATEN/KOTA,44923,BANYUWANGI,0,0,0
2,KECAMATAN,44924,PESANGGARAN,0,0,0
2,KECAMATAN,45048,KABAT,0,0,0
2,KECAMATAN,45065,GLAGAH,0,0,0
2,KECAMATAN,45076,BANYUWANGI,0,0,0
2,KECAMATAN,45095,GIRI,0,0,0
2,KECAMATAN,45102,WONGSOREJO,0,0,0
2,KECAMATAN,45115,SONGGON,0,0,0
2,KECAMATAN,45125,SEMPU,0,0,0
2,KECAMATAN,45133,KALIPURO,0,0,0
2,KECAMATAN,45143,SILIRAGUNG,0,0,0
2,KECAMATAN,45149,TEGALSARI,0,0,0
2,KECAMATAN,45029,ROGOJAMPI,0,0,0
2,KECAMATAN,45017,SINGOJURUH,0,0,0
2,KECAMATAN,44930,BANGOREJO,0,0,0
2,KECAMATAN,44938,PURWOHARJO,0,0,0
2,KECAMATAN,44947,TEGALDLIMO,0,0,0
2,KECAMATAN,44957,MUNCAR,0,0,0
2,KECAMATAN,44968,CLURING,0,0,0
2,KECAMATAN,44978,GAMBIRAN,0,0,0
2,KECAMATAN,44985,SRONO,0,0,0
2,KECAMATAN,44996,GENTENG,0,0,0
2,KECAMATAN,45002,GLENMORE,0,0,0
2,KECAMATAN,45010,KALIBARU,0,0,0
2,KECAMATAN,45156,LICIN,0,0,0
1,KABUPATEN/KOTA,45165,BONDOWOSO,0,0,0
2,KECAMATAN,45166,MAESAN,14705,11612,26317
2,KECAMATAN,45313,KLABANG,8031,3676,11707
2,KECAMATAN,45325,CERMEE,19344,8345,27689
2,KECAMATAN,45340,PRAJEKAN,11161,4564,15725
2,KECAMATAN,45348,PAKEM,5547,8291,13838
2,KECAMATAN,45357,SUMBERWRINGIN,11085,8091,19176
2,KECAMATAN,45364,SEMPOL,4944,2952,7896
2,KECAMATAN,45371,BINAKAL,5158,4363,9521
2,KECAMATAN,45380,TAMAN KROCOK,5982,4726,10708
2,KECAMATAN,45388,JAMBESARI DARUS SHOLAH,12528,6680,19208
2,KECAMATAN,45304,TEGALAMPEL,7236,7193,14429
2,KECAMATAN,45290,WRINGIN,11576,11353,22929
2,KECAMATAN,45278,BONDOWOSO,24342,18119,42461
2,KECAMATAN,45179,TAMANAN,11387,9849,21236
2,KECAMATAN,45189,TLOGOSARI,15739,9326,25065
2,KECAMATAN,45200,SUKOSARI,6200,2882,9082
2,KECAMATAN,45205,PUJER,15999,7354,23353
2,KECAMATAN,45217,GRUJUGAN,13533,6574,20107
2,KECAMATAN,45229,CURAHDAMI,10973,7369,18342
2,KECAMATAN,45242,TENGGARANG,13640,9602,23242
2,KECAMATAN,45255,WONOSARI,13686,10364,24050
2,KECAMATAN,45268,TAPEN,13384,7359,20743
2,KECAMATAN,45398,BOTOLINGGO,14598,4859,19457
1,KABUPATEN/KOTA,45407,SITUBONDO,270778,175503,446281
2,KECAMATAN,45408,JATIBANTENG,8429,4226,12655
2,KECAMATAN,45545,BANYUGLUGUR,7618,5393,13011
2,KECAMATAN,45535,SUMBERMALANG,9919,4584,14503
2,KECAMATAN,45529,BANYUPUTIH,10680,14886,25566
2,KECAMATAN,45518,ASEMBAGUS,15018,10782,25800
2,KECAMATAN,45509,JANGKAR,12085,7884,19969
2,KECAMATAN,45500,ARJASA,13148,9037,22185
2,KECAMATAN,45489,KAPONGAN,12582,9648,22230
2,KECAMATAN,45482,MANGARAN,10536,8397,18933
2,KECAMATAN,45469,PANJI,24436,17923,42359
2,KECAMATAN,45462,SITUBONDO,15940,12228,28168
2,KECAMATAN,45453,PANARUKAN,17703,13201,30904
2,KECAMATAN,45445,KENDIT,10679,6654,17333
2,KECAMATAN,45437,MLANDINGAN,8914,4726,13640
2,KECAMATAN,45428,SUBOH,11406,4822,16228
2,KECAMATAN,45417,BESUKI,22138,12514,34652
2,KECAMATAN,45553,BUNGATAN,8803,6113,14916
1,KABUPATEN/KOTA,45561,PROBOLINGGO,220034,153018,373052
2,KECAMATAN,45562,SUKAPURA,5871,6401,12272
2,KECAMATAN,45753,KRAKSAAN,13405,20287,33692
2,KECAMATAN,45772,KREJENGAN,9235,12275,21510
2,KECAMATAN,45790,PAJARAKAN,9262,9201,18463
2,KECAMATAN,45803,MARON,17383,14500,31883
2,KECAMATAN,45822,GENDING,0,0,0
2,KECAMATAN,45836,DRINGU,11281,19047,30328
2,KECAMATAN,45851,TEGALSIWALAN,9677,7648,17325
2,KECAMATAN,45864,SUMBERASIH,19163,13248,32411
2,KECAMATAN,45878,WONOMERTO,10223,7428,17651
2,KECAMATAN,45890,TONGAS,16535,16712,33247
2,KECAMATAN,45735,BESUK,12430,12826,25256
2,KECAMATAN,45714,PAITON,21951,16036,37987
2,KECAMATAN,45575,SUMBER,8015,7288,15303
2,KECAMATAN,45585,KURIPAN,5210,6966,12176
2,KECAMATAN,45593,BANTARAN,11224,7097,18321
2,KECAMATAN,45604,LECES,15118,12018,27136
2,KECAMATAN,45615,BANYUANYAR,12941,12270,25211
2,KECAMATAN,45630,TIRIS,11580,17293,28873
2,KECAMATAN,45647,KRUCIL,10175,10798,20973
2,KECAMATAN,45662,GADING,11859,14885,26744
2,KECAMATAN,45682,PAKUNIRAN,10794,14036,24830
2,KECAMATAN,45700,KOTAANYAR,9805,11674,21479
2,KECAMATAN,45905,LUMBANG,6545,9452,15997
1,KABUPATEN/KOTA,45916,PASURUAN,269682,279386,549068
2,KECAMATAN,45917,PURWODADI,0,0,0
2,KECAMATAN,46126,BANGIL,0,0,0
2,KECAMATAN,46142,REMBANG,0,0,0
2,KECAMATAN,46160,KRATON,0,0,0
2,KECAMATAN,46186,POHJENTREK,0,0,0
2,KECAMATAN,46196,GONDANGWETAN,0,0,0
2,KECAMATAN,46217,WINONGAN,0,0,0
2,KECAMATAN,46236,GRATI,0,0,0
2,KECAMATAN,46252,NGULING,0,0,0
2,KECAMATAN,46268,LEKOK,0,0,0
2,KECAMATAN,46280,REJOSO,0,0,0
2,KECAMATAN,46111,BEJI,0,0,0
2,KECAMATAN,46095,GEMPOL,0,0,0
2,KECAMATAN,45931,TUTUR,0,0,0
2,KECAMATAN,45944,PUSPO,0,0,0
2,KECAMATAN,45952,LUMBANG,0,0,0
2,KECAMATAN,45965,PASREPAN,0,0,0
2,KECAMATAN,45983,KEJAYAN,0,0,0
2,KECAMATAN,46009,WONOREJO,0,0,0
2,KECAMATAN,46025,PURWOSARI,0,0,0
2,KECAMATAN,46041,SUKOREJO,0,0,0
2,KECAMATAN,46061,PRIGEN,0,0,0
2,KECAMATAN,46076,PANDAAN,0,0,0
2,KECAMATAN,46297,TOSARI,0,0,0
1,KABUPATEN/KOTA,46306,SIDOARJO,0,0,0
2,KECAMATAN,46307,TARIK,19530,19176,38706
2,KECAMATAN,46643,SEDATI,21110,22040,43150
2,KECAMATAN,46627,GEDANGAN,28290,29835,58125
2,KECAMATAN,46611,BUDURAN,23782,21745,45527
2,KECAMATAN,46591,SUKODONO,24501,31668,56169
2,KECAMATAN,46566,TAMAN,43812,59882,103694
2,KECAMATAN,46545,BALONGBENDO,18062,23003,41065
2,KECAMATAN,46522,KRIAN,26213,36760,62973
2,KECAMATAN,46498,WONOAYU,20766,22916,43682
2,KECAMATAN,46475,TULANGAN,22890,28169,51059
2,KECAMATAN,46450,SIDOARJO,46124,54639,100763
2,KECAMATAN,46425,CANDI,35008,37657,72665
2,KECAMATAN,46405,TANGGULANGIN,23035,23700,46735
2,KECAMATAN,46389,JABON,15516,12799,28315
2,KECAMATAN,46369,PORONG,15734,21316,37050
2,KECAMATAN,46349,KREMBUNG,17793,20500,38293
2,KECAMATAN,46328,PRAMBON,17740,25679,43419
2,KECAMATAN,46660,WARU,0,0,0
1,KABUPATEN/KOTA,46678,MOJOKERTO,419906,491484,911390
2,KECAMATAN,46679,JATIREJO,9017,15006,24023
2,KECAMATAN,46969,DAWARBLANDONG,13119,19030,32149
2,KECAMATAN,46952,JETIS,19497,28982,48479
2,KECAMATAN,46931,KEMLAGI,14608,19303,33911
2,KECAMATAN,46916,GEDEG,13890,19132,33022
2,KECAMATAN,46900,SOOKO,17418,21706,39124
2,KECAMATAN,46883,TROWULAN,14058,27498,41556
2,KECAMATAN,46866,PURI,16389,25000,41389
2,KECAMATAN,46848,BANGSAL,13542,16438,29980
2,KECAMATAN,46831,DLANGGU,10625,20087,30712
2,KECAMATAN,46811,MOJOSARI,18287,25289,43576
2,KECAMATAN,46793,KUTOREJO,14576,21934,36510
2,KECAMATAN,46773,PUNGGING,20125,25402,45527
2,KECAMATAN,46753,NGORO,22878,22382,45260
2,KECAMATAN,46739,TRAWAS,6709,11742,18451
2,KECAMATAN,46718,PACET,13049,20911,33960
2,KECAMATAN,46699,GONDANG,10145,14868,25013
2,KECAMATAN,46988,MOJOANYAR,12423,15555,27978
1,KABUPATEN/KOTA,47001,JOMBANG,260355,370265,630620
2,KECAMATAN,47002,PERAK,0,0,0
2,KECAMATAN,47206,TEMBELANG,0,0,0
2,KECAMATAN,47222,PLOSO,0,0,0
2,KECAMATAN,47236,PLANDAAN,12794,10781,23575
2,KECAMATAN,47250,KABUH,0,0,0
2,KECAMATAN,47267,KUDU,8508,10420,18928
2,KECAMATAN,47279,BANDARKEDUNGMULYO,0,0,0
2,KECAMATAN,47291,JOGOROTO,0,0,0
2,KECAMATAN,47303,MEGALUH,10576,12117,22693
2,KECAMATAN,47191,KESAMBEN,0,0,0
2,KECAMATAN,47169,SUMOBITO,0,0,0
2,KECAMATAN,47154,PETERONGAN,0,0,0
2,KECAMATAN,47016,GUDO,13321,17416,30737
2,KECAMATAN,47035,NGORO,0,0,0
2,KECAMATAN,47049,BARENG,8931,21853,30784
2,KECAMATAN,47063,WONOSALAM,0,0,0
2,KECAMATAN,47073,MOJOAGUNG,0,0,0
2,KECAMATAN,47092,MOJOWARNO,18213,32254,50467
2,KECAMATAN,47112,DIWEK,0,0,0
2,KECAMATAN,47133,JOMBANG,34215,42307,76522
2,KECAMATAN,47317,NGUSIKAN,0,0,0
1,KABUPATEN/KOTA,47329,NGANJUK,106558,147148,253706
2,KECAMATAN,47330,SAWAHAN,7974,13813,21787
2,KECAMATAN,47497,SUKOMORO,8794,17356,26150
2,KECAMATAN,47510,NGANJUK,14979,23401,38380
2,KECAMATAN,47526,BAGOR,17014,18906,35920
2,KECAMATAN,47548,WILANGAN,7701,9200,16901
2,KECAMATAN,47555,REJOSO,17830,24094,41924
2,KECAMATAN,47580,GONDANG,11161,20277,31438
2,KECAMATAN,47598,NGLUYU,5164,3976,9140
2,KECAMATAN,47605,LENGKONG,10154,9202,19356
2,KECAMATAN,47480,TANJUNGANOM,21411,42068,63479
2,KECAMATAN,47468,BARON,10408,18111,28519
2,KECAMATAN,47340,NGETOS,5556,13690,19246
2,KECAMATAN,47350,BERBEK,12635,19058,31693
2,KECAMATAN,47370,LOCERET,14377,25685,40062
2,KECAMATAN,47393,PACE,10805,24141,34946
2,KECAMATAN,47412,PRAMBON,13905,26361,40266
2,KECAMATAN,47427,NGRONGGOT,14150,29313,43463
2,KECAMATAN,47441,KERTOSONO,11511,19047,30558
2,KECAMATAN,47456,PATIANROWO,9968,13878,23846
2,KECAMATAN,47622,JATIKALEN,7009,5322,12331
1,KABUPATEN/KOTA,47634,MADIUN,232506,376899,609405
2,KECAMATAN,47635,KEBONSARI,15796,16625,32421
2,KECAMATAN,47831,SAWAHAN,7170,8417,15587
2,KECAMATAN,47812,PILANGKENCENG,13025,18708,31733
2,KECAMATAN,47796,SARADAN,17605,20689,38294
2,KECAMATAN,47781,MEJAYAN,11341,14648,25989
2,KECAMATAN,47762,BALEREJO,11601,15542,27143
2,KECAMATAN,47747,JIWAN,15440,19457,34897
2,KECAMATAN,47733,MADIUN,9909,13976,23885
2,KECAMATAN,47718,WUNGU,13623,19978,33601
2,KECAMATAN,47710,GEMARANG,7190,11121,18311
2,KECAMATAN,47701,KARE,6878,11483,18361
2,KECAMATAN,47683,DAGANGAN,12267,15885,28152
2,KECAMATAN,47663,GEGER,15085,21624,36709
2,KECAMATAN,47650,DOLOPO,12674,20181,32855
2,KECAMATAN,47845,WONOASRI,8388,11668,20056
1,KABUPATEN/KOTA,47856,MAGETAN,177992,240002,417994
2,KECAMATAN,47857,PONCOL,0,0,0
2,KECAMATAN,48089,NGUNTORONADI,0,0,0
2,KECAMATAN,48076,NGARIBOYO,0,0,0
2,KECAMATAN,48063,KARTOHARJO,0,0,0
2,KECAMATAN,48051,KARAS,0,0,0
2,KECAMATAN,48037,KARANGREJO,0,0,0
2,KECAMATAN,48022,BARAT,0,0,0
2,KECAMATAN,48006,MAOSPATI,0,0,0
2,KECAMATAN,47989,BENDO,0,0,0
2,KECAMATAN,47974,SUKOMORO,0,0,0
2,KECAMATAN,47956,PANEKAN,0,0,0
2,KECAMATAN,47940,PLAOSAN,0,0,0
2,KECAMATAN,47925,MAGETAN,0,0,0
2,KECAMATAN,47904,KAWEDANAN,0,0,0
2,KECAMATAN,47891,TAKERAN,0,0,0
2,KECAMATAN,47880,LEMBEYAN,0,0,0
2,KECAMATAN,47866,PARANG,0,0,0
2,KECAMATAN,48099,SIDOREJO,0,0,0
1,KABUPATEN/KOTA,48110,NGAWI,0,0,0
2,KECAMATAN,48111,SINE,8202,16248,24450
2,KECAMATAN,48332,GERIH,7386,12515,19901
2,KECAMATAN,48324,KARANGANYAR,4362,12728,17090
2,KECAMATAN,48313,PITU,8241,9004,17245
2,KECAMATAN,48302,BRINGIN,6436,12197,18633
2,KECAMATAN,48292,PANGKUR,8302,9440,17742
2,KECAMATAN,48284,MANTINGAN,8944,13519,22463
2,KECAMATAN,48271,WIDODAREN,13695,24553,38248
2,KECAMATAN,48258,KEDUNGGALAR,15004,24108,39112
2,KECAMATAN,48243,PARON,22225,29952,52177
2,KECAMATAN,48226,NGAWI,23226,26186,49412
2,KECAMATAN,48213,PADAS,7621,14141,21762
2,KECAMATAN,48195,KARANGJATI,11666,18579,30245
2,KECAMATAN,48180,KWADUNGAN,7551,9297,16848
2,KECAMATAN,48166,GENENG,12644,18298,30942
2,KECAMATAN,48155,KENDAL,11474,15830,27304
2,KECAMATAN,48142,JOGOROGO,9149,13140,22289
2,KECAMATAN,48127,NGRAMBE,8537,14927,23464
2,KECAMATAN,48338,KASREMAN,6070,8507,14577
1,KABUPATEN/KOTA,48347,BOJONEGORO,200735,303169,503904
2,KECAMATAN,48348,NGRAHO,10501,14443,24944
2,KECAMATAN,48649,KALITIDU,15886,11999,27885
2,KECAMATAN,48674,MALO,10359,7215,17574
2,KECAMATAN,48695,PURWOSARI,7946,8210,16156
2,KECAMATAN,48708,PADANGAN,11060,12567,23627
2,KECAMATAN,48725,KASIMAN,7754,9636,17390
2,KECAMATAN,48736,TEMAYANG,11098,9562,20660
2,KECAMATAN,48749,MARGOMULYO,4642,8076,12718
2,KECAMATAN,48756,TRUCUK,10258,10555,20813
2,KECAMATAN,48769,SUKOSEWU,12048,12173,24221
2,KECAMATAN,48784,KEDEWAN,2400,4750,7150
2,KECAMATAN,48790,GONDANG,5783,8806,14589
2,KECAMATAN,48798,SEKAR,5445,9854,15299
2,KECAMATAN,48630,BOJONEGORO,23221,25552,48773
2,KECAMATAN,48608,KAPAS,17280,14009,31289
2,KECAMATAN,48365,TAMBAKREJO,13961,16942,30903
2,KECAMATAN,48384,NGAMBON,3172,3403,6575
2,KECAMATAN,48390,NGASEM,16967,16385,33352
2,KECAMATAN,48414,BUBULAN,4740,3598,8338
2,KECAMATAN,48420,DANDER,22647,21439,44086
2,KECAMATAN,48437,SUGIHWARAS,15117,11098,26215
2,KECAMATAN,48455,KEDUNGADEM,27605,18303,45908
2,KECAMATAN,48479,KEPOH BARU,20631,16057,36688
2,KECAMATAN,48505,BAURENO,22694,21466,44160
2,KECAMATAN,48531,KANOR,19040,14050,33090
2,KECAMATAN,48557,SUMBEREJO,24320,16116,40436
2,KECAMATAN,48584,BALEN,21103,17539,38642
2,KECAMATAN,83884,GAYAM,9599,8504,18103
1,KABUPATEN/KOTA,48805,TUBAN,377277,352307,729584
2,KECAMATAN,48806,KENDURUAN,0,0,0
2,KECAMATAN,48995,JENU,0,0,0
2,KECAMATAN,49013,MERAKURAK,0,0,0
2,KECAMATAN,49033,RENGEL,0,0,0
2,KECAMATAN,49050,SEMANDING,0,0,0
2,KECAMATAN,49068,TUBAN,0,0,0
2,KECAMATAN,49086,PLUMPANG,0,0,0
2,KECAMATAN,49105,PALANG,0,0,0
2,KECAMATAN,49125,WIDANG,0,0,0
2,KECAMATAN,48971,SOKO,0,0,0
2,KECAMATAN,48957,MONTONG,0,0,0
2,KECAMATAN,48816,JATIROGO,0,0,0
2,KECAMATAN,48835,BANGILAN,0,0,0
2,KECAMATAN,48850,BANCAR,0,0,0
2,KECAMATAN,48875,SENORI,0,0,0
2,KECAMATAN,48888,TAMBAKBOYO,0,0,0
2,KECAMATAN,48907,SINGGAHAN,0,0,0
2,KECAMATAN,48920,KEREK,0,0,0
2,KECAMATAN,48938,PARENGAN,0,0,0
2,KECAMATAN,49142,GRABAGAN,0,0,0
1,KABUPATEN/KOTA,49154,LAMONGAN,0,0,0
2,KECAMATAN,49155,SUKORAME,7102,5729,12831
2,KECAMATAN,49425,MANTUP,14300,13855,28155
2,KECAMATAN,49441,SUKODADI,15812,15535,31347
2,KECAMATAN,49462,KARANGGENENG,10862,11184,22046
2,KECAMATAN,49481,KEMBANGBAHU,12627,16429,29056
2,KECAMATAN,49500,KALITENGAH,9831,8859,18690
2,KECAMATAN,49521,TURI,15131,14147,29278
2,KECAMATAN,49541,LAMONGAN,20436,18204,38640
2,KECAMATAN,49562,TIKUNG,11189,14686,25875
2,KECAMATAN,49576,KARANGBINANGUN,10514,9538,20052
2,KECAMATAN,49598,DEKET,13791,10648,24439
2,KECAMATAN,49616,GLAGAH,11767,9759,21526
2,KECAMATAN,49414,SOLOKURO,13703,9138,22841
2,KECAMATAN,49396,PACIRAN,28905,18094,46999
2,KECAMATAN,49378,PUCUK,10391,12886,23277
2,KECAMATAN,49165,BLULUK,7367,5864,13231
2,KECAMATAN,49175,MODO,15959,12673,28632
2,KECAMATAN,49193,NGIMBANG,14802,12903,27705
2,KECAMATAN,49213,BABAT,20396,23267,43663
2,KECAMATAN,49237,KEDUNGPRING,16723,14800,31523
2,KECAMATAN,49261,BRONDONG,17302,16584,33886
2,KECAMATAN,49272,LAREN,12734,9263,21997
2,KECAMATAN,49293,SEKARAN,9309,10423,19732
2,KECAMATAN,49315,MADURAN,8206,7851,16057
2,KECAMATAN,49333,SAMBENG,16081,15487,31568
2,KECAMATAN,49356,SUGIO,15325,18749,34074
2,KECAMATAN,49646,SARIREJO,8021,5694,13715
1,KABUPATEN/KOTA,49656,GRESIK,368586,342249,710835
2,KECAMATAN,49657,DUKUN,21303,11191,32494
2,KECAMATAN,49999,SANGKAPURA,15366,8170,23536
2,KECAMATAN,49977,GRESIK,23747,18494,42241
2,KECAMATAN,49960,DRIYOREJO,24881,28411,53292
2,KECAMATAN,49938,KEBOMAS,29405,25286,54691
2,KECAMATAN,49915,MENGANTI,24456,40606,65062
2,KECAMATAN,49892,BUNGAH,18548,16120,34668
2,KECAMATAN,49866,CERME,22480,21109,43589
2,KECAMATAN,49842,MANYAR,33493,22415,55908
2,KECAMATAN,49820,SIDAYU,13176,8089,21265
2,KECAMATAN,49804,KEDAMEAN,14425,22297,36722
2,KECAMATAN,49790,UJUNGPANGKAH,14888,10255,25143
2,KECAMATAN,49773,WRINGINANOM,19753,21024,40777
2,KECAMATAN,49749,DUDUKSAMPEYAN,17913,10315,28228
2,KECAMATAN,49725,BENJENG,17983,18830,36813
2,KECAMATAN,49710,PANCENG,15201,9317,24518
2,KECAMATAN,49684,BALONGPANGGANG,16806,15889,32695
2,KECAMATAN,50017,TAMBAK,7131,4678,11809
1,KABUPATEN/KOTA,50031,BANGKALAN,350955,312496,663451
2,KECAMATAN,50032,BANGKALAN,0,0,0
2,KECAMATAN,50295,KONANG,0,0,0
2,KECAMATAN,50277,MODUNG,0,0,0
2,KECAMATAN,50257,BLEGA,0,0,0
2,KECAMATAN,50238,TRAGAH,0,0,0
2,KECAMATAN,50214,TANAH MERAH,0,0,0
2,KECAMATAN,50200,LABANG,0,0,0
2,KECAMATAN,50183,KWANYAR,0,0,0
2,KECAMATAN,50169,KOKOP,0,0,0
2,KECAMATAN,50154,TANJUNG BUMI,0,0,0
2,KECAMATAN,50138,SEPULU,0,0,0
2,KECAMATAN,50115,KLAMPIS,0,0,0
2,KECAMATAN,50101,GEGER,0,0,0
2,KECAMATAN,50082,AROSBAYA,0,0,0
2,KECAMATAN,50071,KAMAL,0,0,0
2,KECAMATAN,50058,BURNEH,0,0,0
2,KECAMATAN,50046,SOCAH,0,0,0
2,KECAMATAN,50309,GALIS,0,0,0
1,KABUPATEN/KOTA,50331,SAMPANG,0,0,0
2,KECAMATAN,50332,SRESEH,0,0,0
2,KECAMATAN,50517,PANGARENGAN,0,0,0
2,KECAMATAN,50502,KETAPANG,0,0,0
2,KECAMATAN,50489,SOKOBANAH,0,0,0
2,KECAMATAN,50479,ROBATAL,31627,7634,39261
2,KECAMATAN,50458,BANYUATES,0,0,0
2,KECAMATAN,50447,TAMBELANGAN,0,0,0
2,KECAMATAN,50432,JRENGIK,0,0,0
2,KECAMATAN,50413,KEDUNGDUNG,0,0,0
2,KECAMATAN,50392,OMBEN,0,0,0
2,KECAMATAN,50377,CAMPLONG,0,0,0
2,KECAMATAN,50358,SAMPANG,0,0,0
2,KECAMATAN,50345,TORJUN,0,0,0
2,KECAMATAN,50524,KARANGPENANG,0,0,0
1,KABUPATEN/KOTA,50532,PAMEKASAN,31627,7634,39261
2,KECAMATAN,50533,TLANAKAN,19961,11977,31938
2,KECAMATAN,50714,KADUR,13490,10157,23647
2,KECAMATAN,50700,BATUMARMAR,53230,11809,65039
2,KECAMATAN,50687,WARU,36813,6240,43053
2,KECAMATAN,50674,PAKONG,13628,5560,19188
2,KECAMATAN,50659,LARANGAN,16715,11508,28223
2,KECAMATAN,50645,PEGANTENAN,35708,9944,45652
2,KECAMATAN,50604,PROPPO,41532,9576,51108
2,KECAMATAN,50585,PAMEKASAN,39331,11323,50654
2,KECAMATAN,50574,GALIS,9895,6541,16436
2,KECAMATAN,50551,PADEMAWU,31448,15022,46470
2,KECAMATAN,50725,PASEAN,23833,9982,33815
1,KABUPATEN/KOTA,50735,SUMENEP,335584,119639,455223
2,KECAMATAN,50736,KOTA SUMENEP,25784,14635,40419
2,KECAMATAN,50946,BATANG BATANG,13332,14372,27704
2,KECAMATAN,50963,BATU PUTIH,11438,10733,22171
2,KECAMATAN,50978,DUNGKEK,9106,9155,18261
2,KECAMATAN,50994,GAPURA,8009,12136,20145
2,KECAMATAN,51012,GAYAM,12430,5260,17690
2,KECAMATAN,51023,NONGGUNONG,4252,3166,7418
2,KECAMATAN,51042,MASALEMBU,3849,5462,9311
2,KECAMATAN,51047,ARJASA,27270,10303,37573
2,KECAMATAN,51067,SAPEKEN,15691,5899,21590
2,KECAMATAN,51077,BATUAN,3578,2861,6439
2,KECAMATAN,50934,RUBARU,11981,8830,20811
2,KECAMATAN,50918,DASUK,9241,6717,15958
2,KECAMATAN,50907,PASONGSONGAN,14923,11451,26374
2,KECAMATAN,50753,KALIANGET,10848,10623,21471
2,KECAMATAN,50761,MANDING,8478,6652,15130
2,KECAMATAN,50773,TALANGO,7983,11287,19270
2,KECAMATAN,50782,BLUTO,15715,11357,27072
2,KECAMATAN,50803,SARONGGI,10329,10601,20930
2,KECAMATAN,50818,LENTENG,15212,18664,33876
2,KECAMATAN,50839,GILI GINTING,5115,5188,10303
2,KECAMATAN,50861,GANDING,9872,8476,18348
2,KECAMATAN,50876,PRAGAAN,27194,15251,42445
2,KECAMATAN,50891,AMBUNTEN,11912,10781,22693
2,KECAMATAN,51085,KANGAYAN,8215,2822,11037
1,KABUPATEN/KOTA,51095,KOTA KEDIRI,301757,232682,534439
2,KECAMATAN,51096,MOJOROTO,25896,35205,61101
2,KECAMATAN,51111,KOTA,16532,33583,50115
2,KECAMATAN,51129,PESANTREN,17033,31704,48737
1,KABUPATEN/KOTA,51145,KOTA BLITAR,59461,100492,159953
2,KECAMATAN,51146,KEPANJENKIDUL,8305,16391,24696
2,KECAMATAN,51154,SUKOREJO,8827,19603,28430
2,KECAMATAN,51162,SANANWETAN,12217,18605,30822
1,KABUPATEN/KOTA,51170,KOTA MALANG,29349,54599,83948
2,KECAMATAN,51171,BLIMBING,0,0,0
2,KECAMATAN,51183,KLOJEN,0,0,0
2,KECAMATAN,51195,KEDUNGKANDANG,0,0,0
2,KECAMATAN,51208,SUKUN,0,0,0
2,KECAMATAN,51220,LOWOKWARU,0,0,0
1,KABUPATEN/KOTA,51233,KOTA PROBOLINGGO,0,0,0
2,KECAMATAN,51234,KADEMANGAN,12942,10230,23172
2,KECAMATAN,51241,WONOASIH,10572,7787,18359
2,KECAMATAN,51248,MAYANGAN,16727,18771,35498
2,KECAMATAN,83538,KANIGARAN,17950,14000,31950
2,KECAMATAN,83539,KEDOPAK,10921,7361,18282
1,KABUPATEN/KOTA,51268,KOTA PASURUAN,69112,58149,127261
2,KECAMATAN,51269,GADINGREJO,12537,10327,22864
2,KECAMATAN,51281,PURWOREJO,17463,12898,30361
2,KECAMATAN,51292,BUGUL KIDUL,9681,6086,15767
2,KECAMATAN,83540,PANGGUNGREJO,19286,14585,33871
1,KABUPATEN/KOTA,51306,KOTA MOJOKERTO,58967,43896,102863
2,KECAMATAN,51307,PRAJURIT KULON,0,0,0
2,KECAMATAN,51316,MAGERSARI,0,0,0
1,KABUPATEN/KOTA,51327,KOTA MADIUN,0,0,0
2,KECAMATAN,51328,KARTOHARJO,12437,17578,30015
2,KECAMATAN,51338,MANGUHARJO,11306,19986,31292
2,KECAMATAN,51348,TAMAN,17305,27495,44800
1,KABUPATEN/KOTA,51358,KOTA SURABAYA,41048,65059,106107
2,KECAMATAN,51359,KARANGPILANG,0,0,0
2,KECAMATAN,51469,LAKARSANTRI,0,0,0
2,KECAMATAN,51476,BENOWO,0,0,0
2,KECAMATAN,51482,WIYUNG,0,0,0
2,KECAMATAN,51487,DUKUHPAKIS,0,0,0
2,KECAMATAN,51492,GAYUNGAN,0,0,0
2,KECAMATAN,51497,JAMBANGAN,0,0,0
2,KECAMATAN,51502,TENGGILIS MEJOYO,0,0,0
2,KECAMATAN,51508,GUNUNG ANYAR,0,0,0
2,KECAMATAN,51513,MULYOREJO,0,0,0
2,KECAMATAN,51520,SUKOMANUNGGAL,0,0,0
2,KECAMATAN,51527,ASEM ROWO,0,0,0
2,KECAMATAN,51533,BULAK,0,0,0
2,KECAMATAN,51539,PAKAL,0,0,0
2,KECAMATAN,51464,KENJERAN,0,0,0
2,KECAMATAN,51458,SEMAMPIR,0,0,0
2,KECAMATAN,51452,KREMBANGAN,0,0,0
2,KECAMATAN,51364,WONOCOLO,0,0,0
2,KECAMATAN,51370,RUNGKUT,0,0,0
2,KECAMATAN,51377,WONOKROMO,0,0,0
2,KECAMATAN,51384,TEGALSARI,0,0,0
2,KECAMATAN,51390,SAWAHAN,0,0,0
2,KECAMATAN,51397,GENTENG,0,0,0
2,KECAMATAN,51403,GUBENG,0,0,0
2,KECAMATAN,51410,SUKOLILO,0,0,0
2,KECAMATAN,51418,TAMBAKSARI,0,0,0
2,KECAMATAN,51427,SIMOKERTO,0,0,0
2,KECAMATAN,51433,PABEAN CANTIKAN,0,0,0
2,KECAMATAN,51439,BUBUTAN,0,0,0
2,KECAMATAN,51445,TANDES,0,0,0
2,KECAMATAN,51545,SAMBIKEREP,0,0,0
1,KABUPATEN/KOTA,51550,KOTA BATU,0,0,0
2,KECAMATAN,51551,BATU,21638,32771,54409
2,KECAMATAN,51560,BUMIAJI,13441,22958,36399
2,KECAMATAN,51570,JUNREJO,11900,17326,29226
0,PROVINSI,51578,BANTEN,0,0,0
1,KABUPATEN/KOTA,51579,PANDEGLANG,46979,73055,120034
2,KECAMATAN,51580,SUMUR,5055,6898,11953
2,KECAMATAN,51796,BANJAR,9541,5456,14997
2,KECAMATAN,51808,PANDEGLANG,16470,6766,23236
2,KECAMATAN,51813,CADASARI,11948,4479,16427
2,KECAMATAN,51825,CISATA,9683,2455,12138
2,KECAMATAN,51835,PATIA,7040,6279,13319
2,KECAMATAN,51845,KARANG TANJUNG,12399,5679,18078
2,KECAMATAN,51850,CIKEDAL,10915,5759,16674
2,KECAMATAN,51861,CIBITUNG,5140,5657,10797
2,KECAMATAN,51872,CARITA,9244,8676,17920
2,KECAMATAN,51883,SUKARESMI,7632,9595,17227
2,KECAMATAN,51894,MEKARJAYA,5278,4214,9492
2,KECAMATAN,51903,SINDANGRESMI,0,0,0
2,KECAMATAN,83878,PULOSARI,9049,4253,13302
2,KECAMATAN,83879,KORONCONG,6129,3073,9202
2,KECAMATAN,83880,MAJASARI,17833,5918,23751
2,KECAMATAN,51785,KADUHEJO,13538,4326,17864
2,KECAMATAN,51773,CIMANUK,13790,4769,18559
2,KECAMATAN,51757,MANDALAWANGI,16404,6987,23391
2,KECAMATAN,51588,CIMANGGU,7732,12702,20434
2,KECAMATAN,51601,CIBALIUNG,6012,8110,14122
2,KECAMATAN,51611,CIKEUSIK,11525,15178,26703
2,KECAMATAN,51626,CIGEULIS,7566,10590,18156
2,KECAMATAN,51636,PANIMBANG,9401,15941,25342
2,KECAMATAN,51643,ANGSANA,6105,7671,13776
2,KECAMATAN,51653,MUNJUL,7005,5584,12589
2,KECAMATAN,51663,PAGELARAN,11501,6863,18364
2,KECAMATAN,51677,BOJONG,10868,5834,16702
2,KECAMATAN,51686,PICUNG,0,0,0
2,KECAMATAN,51695,LABUAN,15326,12021,27347
2,KECAMATAN,51705,MENES,14142,4274,18416
2,KECAMATAN,51717,SAKETI,13977,6920,20897
2,KECAMATAN,51732,CIPEUCANG,8987,3732,12719
2,KECAMATAN,51743,JIPUT,11277,4758,16035
2,KECAMATAN,83881,SOBANG,7257,12555,19812
1,KABUPATEN/KOTA,51913,LEBAK,335769,233972,569741
2,KECAMATAN,51914,MALINGPING,14752,15648,30400
2,KECAMATAN,52130,CIJAKU,6275,8044,14319
2,KECAMATAN,52141,CIKULUR,12433,9247,21680
2,KECAMATAN,52155,CIBADAK,19314,10543,29857
2,KECAMATAN,52171,CIBEBER,13450,22294,35744
2,KECAMATAN,52194,CILOGRANG,9250,8418,17668
2,KECAMATAN,52205,WANASALAM,11197,13744,24941
2,KECAMATAN,52219,SOBANG,7063,9692,16755
2,KECAMATAN,52230,CURUG BITUNG,6759,9342,16101
2,KECAMATAN,52241,KALANGANYAR,10134,5147,15281
2,KECAMATAN,52249,LEBAKGEDONG,5747,5835,11582
2,KECAMATAN,52256,CIHARA,6347,9133,15480
2,KECAMATAN,52266,CIRINTEN,7567,6169,13736
2,KECAMATAN,52117,WARUNGGUNUNG,15579,9572,25151
2,KECAMATAN,52100,RANGKASBITUNG,40613,24328,64941
2,KECAMATAN,51929,PANGGARANGAN,9664,11490,21154
2,KECAMATAN,51941,BAYAH,11193,13468,24661
2,KECAMATAN,51953,CIPANAS,15284,8145,23429
2,KECAMATAN,51968,MUNCANG,9346,6712,16058
2,KECAMATAN,51981,LEUWIDAMAR,12332,10252,22584
2,KECAMATAN,51994,BOJONGMANIK,5689,5934,11623
2,KECAMATAN,52004,GUNUNGKENCANA,9206,7864,17070
2,KECAMATAN,52017,BANJARSARI,15665,11109,26774
2,KECAMATAN,52038,CILELES,11007,10858,21865
2,KECAMATAN,52051,CIMARGA,16815,13379,30194
2,KECAMATAN,52069,SAJIRA,14681,8501,23182
2,KECAMATAN,52085,MAJA,16192,8555,24747
2,KECAMATAN,52277,CIGEMLONG,4146,7445,11591
1,KABUPATEN/KOTA,52287,TANGERANG,337700,290868,628568
2,KECAMATAN,52288,BALARAJA,39104,18981,58085
2,KECAMATAN,52470,CURUG,44755,33089,77844
2,KECAMATAN,52478,CIKUPA,0,0,0
2,KECAMATAN,52493,PANONGAN,0,0,0
2,KECAMATAN,52502,LEGOK,32888,20300,53188
2,KECAMATAN,52514,PAGEDANGAN,0,0,0
2,KECAMATAN,52526,CISAUK,0,0,0
2,KECAMATAN,52533,SUKAMULYA,0,0,0
2,KECAMATAN,52542,KELAPA DUA,40733,46848,87581
2,KECAMATAN,52549,SINDANG JAYA,0,0,0
2,KECAMATAN,52557,SEPATAN TIMUR,0,0,0
2,KECAMATAN,52566,SOLEAR,0,0,0
2,KECAMATAN,52574,GUNUNG KALER,0,0,0
2,KECAMATAN,52461,SEPATAN,0,0,0
2,KECAMATAN,52446,PAKUHAJI,0,0,0
2,KECAMATAN,52435,KOSAMBI,0,0,0
2,KECAMATAN,52298,JAYANTI,0,0,0
2,KECAMATAN,52307,TIGARAKSA,40059,25080,65139
2,KECAMATAN,52322,JAMBE,0,0,0
2,KECAMATAN,52333,CISOKA,0,0,0
2,KECAMATAN,52344,KRESEK,0,0,0
2,KECAMATAN,52355,KRONJO,0,0,0
2,KECAMATAN,52367,MAUK,30769,13589,44358
2,KECAMATAN,52380,KEMIRI,0,0,0
2,KECAMATAN,52388,SUKADIRI,0,0,0
2,KECAMATAN,52397,RAJEG,0,0,0
2,KECAMATAN,52411,PASAR KEMIS,0,0,0
2,KECAMATAN,52421,TELUKNAGA,0,0,0
2,KECAMATAN,52584,MEKAR BARU,0,0,0
1,KABUPATEN/KOTA,52593,SERANG,228308,157887,386195
2,KECAMATAN,52594,KRAMATWATU,0,0,0
2,KECAMATAN,52798,CIKEUSAL,0,0,0
2,KECAMATAN,52814,PAMARAYAN,0,0,0
2,KECAMATAN,52824,KOPO,0,0,0
2,KECAMATAN,52835,JAWILAN,0,0,0
2,KECAMATAN,52845,CIOMAS,0,0,0
2,KECAMATAN,52857,PABUARAN,0,0,0
2,KECAMATAN,52865,PADARINCANG,0,0,0
2,KECAMATAN,52880,ANYAR,0,0,0
2,KECAMATAN,52891,CINANGKA,0,0,0
2,KECAMATAN,52905,MANCAK,0,0,0
2,KECAMATAN,52919,GUNUNG SARI,0,0,0
2,KECAMATAN,52927,BANDUNG,0,0,0
2,KECAMATAN,52783,BAROS,0,0,0
2,KECAMATAN,52773,TUNJUNG TEJA,0,0,0
2,KECAMATAN,52759,PETIR,0,0,0
2,KECAMATAN,52610,WARINGINKURUNG,0,0,0
2,KECAMATAN,52622,BOJONEGARA,0,0,0
2,KECAMATAN,52633,PULO AMPEL,0,0,0
2,KECAMATAN,52643,CIRUAS,0,0,0
2,KECAMATAN,52661,KRAGILAN,0,0,0
2,KECAMATAN,52676,PONTANG,0,0,0
2,KECAMATAN,52692,TIRTAYASA,0,0,0
2,KECAMATAN,52707,TANARA,0,0,0
2,KECAMATAN,52717,CIKANDE,0,0,0
2,KECAMATAN,52730,KIBIN,0,0,0
2,KECAMATAN,52740,CARENANG,0,0,0
2,KECAMATAN,52751,BINUANG,0,0,0
2,KECAMATAN,83885,LEBAK WANGI,0,0,0
1,KABUPATEN/KOTA,52936,KOTA TANGERANG,0,0,0
2,KECAMATAN,52937,TANGERANG,41589,41813,83402
2,KECAMATAN,53037,KARANG TENGAH,0,0,0
2,KECAMATAN,53025,PINANG,50422,33996,84418
2,KECAMATAN,53017,NEGLASARI,0,0,0
2,KECAMATAN,53010,CIBODAS,40032,34592,74624
2,KECAMATAN,53004,PERIUK,34094,32920,67014
2,KECAMATAN,52987,KARAWACI,0,0,0
2,KECAMATAN,52978,CILEDUG,37918,33140,71058
2,KECAMATAN,52967,CIPONDOH,0,0,0
2,KECAMATAN,52961,BENDA,0,0,0
2,KECAMATAN,52953,BATUCEPER,27323,20340,47663
2,KECAMATAN,52946,JATIUWUNG,35243,16181,51424
2,KECAMATAN,53045,LARANGAN,40981,41328,82309
1,KABUPATEN/KOTA,53054,KOTA CILEGON,307602,254310,561912
2,KECAMATAN,53055,CIBEBER,15916,11200,27116
2,KECAMATAN,53062,CILEGON,14216,8610,22826
2,KECAMATAN,53068,PULOMERAK,13529,10593,24122
2,KECAMATAN,53073,CIWANDAN,17696,7343,25039
2,KECAMATAN,53080,JOMBANG,17258,15164,32422
2,KECAMATAN,53086,GEROGOL,14408,7491,21899
2,KECAMATAN,53091,PURWAKARTA,14434,8388,22822
2,KECAMATAN,53098,CITANGKIL,24153,13119,37272
1,KABUPATEN/KOTA,53106,KOTA SERANG,131610,81908,213518
2,KECAMATAN,53107,SERANG,0,0,0
2,KECAMATAN,53120,KASEMEN,0,0,0
2,KECAMATAN,53131,WALANTAKA,0,0,0
2,KECAMATAN,53146,CURUG,0,0,0
2,KECAMATAN,53157,CIPOCOK JAYA,0,0,0
2,KECAMATAN,53166,TAKTAKAN,0,0,0
1,KABUPATEN/KOTA,53179,KOTA TANGERANG SELATAN,0,0,0
2,KECAMATAN,53180,SERPONG,34215,38978,73193
2,KECAMATAN,53190,SERPONG UTARA,0,0,0
2,KECAMATAN,53198,PONDOK AREN,76335,78592,154927
2,KECAMATAN,53210,CIPUTAT,0,0,0
2,KECAMATAN,53218,CIPUTAT TIMUR,45593,49146,94739
2,KECAMATAN,53225,PAMULANG,79800,82822,162622
2,KECAMATAN,53234,SETU,21305,17609,38914
0,PROVINSI,53241,BALI,0,0,0
1,KABUPATEN/KOTA,53242,JEMBRANA,257248,267147,524395
2,KECAMATAN,53243,NEGARA,18440,26407,44847
2,KECAMATAN,53256,MENDOYO,9256,26555,35811
2,KECAMATAN,53268,PEKUTATAN,5935,10668,16603
2,KECAMATAN,53277,MELAYA,9342,19691,29033
2,KECAMATAN,53288,JEMBRANA,10305,21480,31785
1,KABUPATEN/KOTA,53299,TABANAN,53278,104801,158079
2,KECAMATAN,53300,SELEMADEG,2096,13427,15523
2,KECAMATAN,53412,BATURITI,9761,20496,30257
2,KECAMATAN,53393,PENEBEL,10863,22707,33570
2,KECAMATAN,53377,MARGA,8134,21654,29788
2,KECAMATAN,53361,KEDIRI,16087,34102,50189
2,KECAMATAN,53348,TABANAN,12549,34325,46874
2,KECAMATAN,53332,KERAMBITAN,8241,20049,28290
2,KECAMATAN,53322,SELEMADEG BARAT,4062,10490,14552
2,KECAMATAN,53311,SELEMADEG TIMUR,4196,11969,16165
2,KECAMATAN,53425,PUPUAN,6225,21677,27902
1,KABUPATEN/KOTA,53439,BADUNG,82214,210896,293110
2,KECAMATAN,53440,KUTA,6269,18968,25237
2,KECAMATAN,53446,MENGWI,21692,52545,74237
2,KECAMATAN,53467,ABIANSEMAL,16355,40988,57343
2,KECAMATAN,53486,PETANG,6285,12191,18476
2,KECAMATAN,53494,KUTA SELATAN,15350,32360,47710
2,KECAMATAN,53501,KUTA UTARA,12115,32165,44280
1,KABUPATEN/KOTA,53508,GIANYAR,78066,189217,267283
2,KECAMATAN,53509,SUKAWATI,11333,47388,58721
2,KECAMATAN,53522,BLAHBATUH,9542,28930,38472
2,KECAMATAN,53532,GIANYAR,13280,40808,54088
2,KECAMATAN,53550,TAMPAKSIRING,5717,25216,30933
2,KECAMATAN,53559,UBUD,9296,33929,43225
2,KECAMATAN,53568,TEGALALLANG,8193,25905,34098
2,KECAMATAN,53576,PAYANGAN,6592,20949,27541
1,KABUPATEN/KOTA,53586,KLUNGKUNG,63953,223125,287078
2,KECAMATAN,53587,NUSA PENIDA,12150,15767,27917
2,KECAMATAN,53604,BANJARANGKAN,6850,16632,23482
2,KECAMATAN,53618,KLUNGKUNG,10963,22422,33385
2,KECAMATAN,53637,DAWAN,5958,16010,21968
1,KABUPATEN/KOTA,53650,BANGLI,35921,70831,106752
2,KECAMATAN,53651,SUSUT,8102,20530,28632
2,KECAMATAN,53661,BANGLI,9187,22608,31795
2,KECAMATAN,53671,TEMBUKU,5989,18607,24596
2,KECAMATAN,53678,KINTAMANI,14039,40783,54822
1,KABUPATEN/KOTA,53727,KARANGASEM,37317,102528,139845
2,KECAMATAN,53728,RENDANG,8907,14686,23593
2,KECAMATAN,53735,SIDEMEN,5905,16453,22358
2,KECAMATAN,53746,MANGGIS,6901,18169,25070
2,KECAMATAN,53759,KARANGASEM,17124,31766,48890
2,KECAMATAN,53771,ABANG,10958,25620,36578
2,KECAMATAN,53786,BEBANDEM,10830,18368,29198
2,KECAMATAN,53795,SELAT,7165,17980,25145
2,KECAMATAN,53804,KUBU,12970,16822,29792
1,KABUPATEN/KOTA,53814,BULELENG,80760,159864,240624
2,KECAMATAN,53815,GEROKGAK,15376,26829,42205
2,KECAMATAN,53830,SERIRIT,14950,23685,38635
2,KECAMATAN,53852,BUSUNG BIU,7294,17486,24780
2,KECAMATAN,53868,BANJAR,12583,28070,40653
2,KECAMATAN,53886,SUKASADA,12050,24730,36780
2,KECAMATAN,53902,BULELENG,20569,45577,66146
2,KECAMATAN,53932,SAWAN,8168,24260,32428
2,KECAMATAN,53947,KUBUTAMBAHAN,7441,19231,26672
2,KECAMATAN,53961,TEJAKULA,4421,22360,26781
1,KABUPATEN/KOTA,53972,KOTA DENPASAR,102852,232228,335080
2,KECAMATAN,53973,DENPASAR SELATAN,22047,63072,85119
2,KECAMATAN,53984,DENPASAR TIMUR,12967,46845,59812
2,KECAMATAN,53996,DENPASAR BARAT,26363,68230,94593
2,KECAMATAN,54008,DENPASAR UTARA,18503,63473,81976
0,PROVINSI,54020,NUSA TENGGARA BARAT,0,0,0
1,KABUPATEN/KOTA,54021,LOMBOK BARAT,79880,241620,321500
2,KECAMATAN,54022,GERUNG,35127,8377,43504
2,KECAMATAN,54111,BATU LAYAR,20702,5925,26627
2,KECAMATAN,54105,LEMBAR,17663,6825,24488
2,KECAMATAN,54094,LINGSAR,28021,10248,38269
2,KECAMATAN,54080,GUNUNGSARI,36017,10051,46068
2,KECAMATAN,54069,LABUAPI,29243,6295,35538
2,KECAMATAN,54062,SEKOTONG,19572,9377,28949
2,KECAMATAN,54045,NARMADA,37474,14159,51633
2,KECAMATAN,54034,KEDIRI,25993,4354,30347
2,KECAMATAN,54118,KURIPAN,14754,3518,18272
1,KABUPATEN/KOTA,54123,LOMBOK TENGAH,264566,79129,343695
2,KECAMATAN,54124,PRAYA,46096,12956,59052
2,KECAMATAN,54240,PRAYA BARAT DAYA,20063,6895,26958
2,KECAMATAN,54229,PRAYA TENGAH,26887,7597,34484
2,KECAMATAN,54219,KOPANG,33793,10706,44499
2,KECAMATAN,54211,PRINGGARATA,22808,11330,34138
2,KECAMATAN,54200,JANAPRIA,32028,8038,40066
2,KECAMATAN,54189,PRAYA TIMUR,27544,12019,39563
2,KECAMATAN,54179,PRAYA BARAT,28144,10197,38341
2,KECAMATAN,54163,PUJUT,37982,17423,55405
2,KECAMATAN,54153,BATUKLIANG,29263,12250,41513
2,KECAMATAN,54139,JONGGAT,37787,12812,50599
2,KECAMATAN,54251,BATUKLIANG UTARA,20233,6817,27050
1,KABUPATEN/KOTA,54260,LOMBOK TIMUR,362628,129040,491668
2,KECAMATAN,54261,KERUAK,20366,6057,26423
2,KECAMATAN,54344,PRINGGASELA,22359,6865,29224
2,KECAMATAN,54349,SURALAGA,20089,8854,28943
2,KECAMATAN,54356,WANASABA,29945,7421,37366
2,KECAMATAN,54363,SEMBALUN,7845,3466,11311
2,KECAMATAN,54368,SUWELA,15264,6188,21452
2,KECAMATAN,54375,LABUHAN HAJI,24367,6505,30872
2,KECAMATAN,54383,SAKRA TIMUR,15562,6510,22072
2,KECAMATAN,54389,SAKRA BARAT,18774,7668,26442
2,KECAMATAN,54338,MONTONG GADING,17521,6041,23562
2,KECAMATAN,54332,SAMBELIA,10475,5775,16250
2,KECAMATAN,54266,SAKRA,23304,6451,29755
2,KECAMATAN,54272,TERARA,28186,8338,36524
2,KECAMATAN,54280,SIKUR,29868,9454,39322
2,KECAMATAN,54288,MASBAGIK,44466,10279,54745
2,KECAMATAN,54296,SUKAMULIA,13822,3510,17332
2,KECAMATAN,54302,SELONG,36603,8288,44891
2,KECAMATAN,54314,PRINGGABAYA,36013,13434,49447
2,KECAMATAN,54322,AIKMEL,35889,16393,52282
2,KECAMATAN,54395,JEROWARU,20828,8098,28926
1,KABUPATEN/KOTA,54400,SUMBAWA,471546,155595,627141
2,KECAMATAN,54401,LUNYUK,6484,3889,10373
2,KECAMATAN,54519,LABANGKA,3444,1766,5210
2,KECAMATAN,54525,BUER,4508,3363,7871
2,KECAMATAN,54532,RHEE,2033,2082,4115
2,KECAMATAN,54537,UNTER IWES,8807,2732,11539
2,KECAMATAN,54546,MOYO UTARA,4420,1639,6059
2,KECAMATAN,54553,MARONGE,3767,1984,5751
2,KECAMATAN,54558,TARANO,4879,3688,8567
2,KECAMATAN,54567,LOPOK,7142,4039,11181
2,KECAMATAN,54575,LENANGGUAR,2751,1403,4154
2,KECAMATAN,54580,ORONG TELU,1634,999,2633
2,KECAMATAN,54511,LABUHAN BADAS,10407,6264,16671
2,KECAMATAN,54502,ALAS BARAT,7630,3679,11309
2,KECAMATAN,54409,ALAS,9407,5921,15328
2,KECAMATAN,54418,UTAN,10274,6027,16301
2,KECAMATAN,54428,BATU LANTEH,4458,1478,5936
2,KECAMATAN,54435,SUMBAWA,20983,9951,30934
2,KECAMATAN,54444,MOYO HILIR,10159,3976,14135
2,KECAMATAN,54455,MOYO HULU,8516,4749,13265
2,KECAMATAN,54468,ROPANG,2065,1110,3175
2,KECAMATAN,54474,LAPE,6934,3081,10015
2,KECAMATAN,54479,PLAMPANG,10389,5546,15935
2,KECAMATAN,54491,EMPANG,7815,5527,13342
2,KECAMATAN,54585,LANTUNG,1149,646,1795
1,KABUPATEN/KOTA,54590,DOMPU,160055,85539,245594
2,KECAMATAN,54591,DOMPU,20307,7573,27880
2,KECAMATAN,54606,KEMPO,5876,4334,10210
2,KECAMATAN,54621,KILO,4173,2907,7080
2,KECAMATAN,54628,WOJA,23787,6455,30242
2,KECAMATAN,54641,PEKAT,11348,4409,15757
2,KECAMATAN,54650,MANGGELEWA,10634,4799,15433
2,KECAMATAN,54660,PAJO,3946,2613,6559
1,KABUPATEN/KOTA,54666,BIMA,80071,33090,113161
2,KECAMATAN,54667,MONTA,12132,4158,16290
2,KECAMATAN,54837,LAMBITU,1899,897,2796
2,KECAMATAN,54831,PARADO,3459,1210,4669
2,KECAMATAN,54824,SOROMANDI,6099,2925,9024
2,KECAMATAN,54818,TAMBORA,2977,898,3875
2,KECAMATAN,54807,MADAPANGGA,11572,4056,15628
2,KECAMATAN,54794,LAMBU,9291,7400,16691
2,KECAMATAN,54781,LANGGUDU,9581,4432,14013
2,KECAMATAN,54774,AMBALAWI,7547,2223,9770
2,KECAMATAN,54767,SANGGAR,4389,1890,6279
2,KECAMATAN,54758,DONGGO,6796,3926,10722
2,KECAMATAN,54746,WERA,10583,3909,14492
2,KECAMATAN,54728,SAPE,18741,8296,27037
2,KECAMATAN,54718,WAWO,6694,2243,8937
2,KECAMATAN,54709,BELO,9428,3198,12626
2,KECAMATAN,54693,WOHA,17163,6135,23298
2,KECAMATAN,54680,BOLO,18939,6451,25390
2,KECAMATAN,54843,PALIBELO,11550,3089,14639
1,KABUPATEN/KOTA,54853,SUMBAWA BARAT,168840,67336,236176
2,KECAMATAN,54854,JEREWEH,3518,1366,4884
2,KECAMATAN,54859,TALIWANG,17911,8002,25913
2,KECAMATAN,54874,SETELUK,6027,3421,9448
2,KECAMATAN,54885,SEKONGKANG,2490,1626,4116
2,KECAMATAN,54893,BRANG REA,5402,2320,7722
2,KECAMATAN,54903,POTO TANO,3410,2295,5705
2,KECAMATAN,54912,BRANG ENE,2316,902,3218
2,KECAMATAN,54919,MALUK,2860,2253,5113
1,KABUPATEN/KOTA,55026,LOMBOK UTARA,43934,22185,66119
2,KECAMATAN,55027,TANJUNG,16376,10895,27271
2,KECAMATAN,55035,GANGGA,19140,6418,25558
2,KECAMATAN,55041,KAYANGAN,18048,5380,23428
2,KECAMATAN,55050,BAYAN,17154,8682,25836
2,KECAMATAN,55060,PEMENANG,12621,4471,17092
1,KABUPATEN/KOTA,54925,KOTA MATARAM,83339,35846,119185
2,KECAMATAN,54926,AMPENAN,29978,12509,42487
2,KECAMATAN,54937,MATARAM,0,0,0
2,KECAMATAN,54947,CAKRANEGARA,0,0,0
2,KECAMATAN,54958,SEKARBELA,20223,5899,26122
2,KECAMATAN,54964,SELAPARANG,0,0,0
2,KECAMATAN,54974,SANDUBAYA,0,0,0
1,KABUPATEN/KOTA,54982,KOTA BIMA,50201,18408,68609
2,KECAMATAN,54983,RASANAE BARAT,11255,5313,16568
2,KECAMATAN,54990,RASANAE TIMUR,7781,1924,9705
2,KECAMATAN,54998,ASAKOTA,11720,3835,15555
2,KECAMATAN,55003,RABA,16782,4233,21015
2,KECAMATAN,55015,MPUNDA,12356,3611,15967
0,PROVINSI,55065,NUSA TENGGARA TIMUR,0,0,0
1,KABUPATEN/KOTA,55066,KUPANG,59894,18916,78810
2,KECAMATAN,55094,SEMAU,0,0,0
2,KECAMATAN,55265,AMARASI TIMUR,0,0,0
2,KECAMATAN,55270,AMABI OEFETO TIMUR,0,0,0
2,KECAMATAN,55281,AMFOANG BARAT DAYA,0,0,0
2,KECAMATAN,55286,AMFOANG BARAT LAUT,0,0,0
2,KECAMATAN,55293,SEMAU SELATAN,0,0,0
2,KECAMATAN,55300,TAEBENU,0,0,0
2,KECAMATAN,55309,AMABI OEFETO,0,0,0
2,KECAMATAN,55317,AMFOANG TIMUR,0,0,0
2,KECAMATAN,55323,FATULEU BARAT,0,0,0
2,KECAMATAN,55329,FATULEU TENGAH,0,0,0
2,KECAMATAN,55259,AMARASI SELATAN,0,0,0
2,KECAMATAN,55250,AMARASI BARAT,0,0,0
2,KECAMATAN,55107,KUPANG BARAT,0,0,0
2,KECAMATAN,55120,KUPANG TIMUR,0,0,0
2,KECAMATAN,55138,SULAMU,0,0,0
2,KECAMATAN,55146,KUPANG TENGAH,0,0,0
2,KECAMATAN,55160,AMARASI,0,0,0
2,KECAMATAN,55170,FATULEU,0,0,0
2,KECAMATAN,55186,TAKARI,0,0,0
2,KECAMATAN,55197,AMFOANG SELATAN,0,0,0
2,KECAMATAN,55209,AMFOANG UTARA,0,0,0
2,KECAMATAN,55237,NEKAMESE,0,0,0
2,KECAMATAN,55338,AMFOANG TENGAH,0,0,0
1,KABUPATEN/KOTA,55347,TIMOR TENGAH SELATAN,0,0,0
2,KECAMATAN,55348,KOTA SOE,0,0,0
2,KECAMATAN,55518,OENINO,0,0,0
2,KECAMATAN,55526,KOLBANO,0,0,0
2,KECAMATAN,55538,KOT OLIN,0,0,0
2,KECAMATAN,55547,KUALIN,0,0,0
2,KECAMATAN,55555,MOLLO BARAT,0,0,0
2,KECAMATAN,55561,KOK BAUN,0,0,0
2,KECAMATAN,55568,NOEBANA,0,0,0
2,KECAMATAN,55573,SANTIAN,0,0,0
2,KECAMATAN,55578,NOEBEBA,0,0,0
2,KECAMATAN,55585,KUATNANA,0,0,0
2,KECAMATAN,55593,FAUTMOLO,0,0,0
2,KECAMATAN,55598,FATUKOPA,0,0,0
2,KECAMATAN,55603,MOLLO TENGAH,0,0,0
2,KECAMATAN,55610,TOBU,0,0,0
2,KECAMATAN,55508,NUNKOLO,0,0,0
2,KECAMATAN,55500,TOIANAS,0,0,0
2,KECAMATAN,55362,MOLLO SELATAN,0,0,0
2,KECAMATAN,55370,MOLLO UTARA,0,0,0
2,KECAMATAN,55384,AMANUBAN TIMUR,0,0,0
2,KECAMATAN,55395,AMANUBAN TENGAH,0,0,0
2,KECAMATAN,55407,AMANUBAN SELATAN,0,0,0
2,KECAMATAN,55418,AMANUBAN BARAT,0,0,0
2,KECAMATAN,55426,AMANATUN SELATAN,0,0,0
2,KECAMATAN,55440,AMANATUN UTARA,0,0,0
2,KECAMATAN,55461,KUANFATU,0,0,0
2,KECAMATAN,55469,FATUMNASI,0,0,0
2,KECAMATAN,55474,POLEN,0,0,0
2,KECAMATAN,55485,BATU PUTIH,0,0,0
2,KECAMATAN,55493,BOKING,0,0,0
2,KECAMATAN,55615,NUNBENA,0,0,0
1,KABUPATEN/KOTA,55620,TIMOR TENGAH UTARA,0,0,0
2,KECAMATAN,55621,MIOMAFO TIMUR,2365,3118,5483
2,KECAMATAN,55739,BIKOMI SELATAN,2097,2374,4471
2,KECAMATAN,55748,BIKOMI TENGAH,1562,1725,3287
2,KECAMATAN,55757,BIKOMI NILULAT,1017,1171,2188
2,KECAMATAN,55764,BIKOMI UTARA,1278,1729,3007
2,KECAMATAN,55774,NAIBENU,1233,1173,2406
2,KECAMATAN,55779,INSANA FAFINESU,575,1887,2462
2,KECAMATAN,55786,INSANA BARAT,1605,2440,4045
2,KECAMATAN,55794,INSANA TENGAH,1743,2938,4681
2,KECAMATAN,55800,BIBOKI TAN PAH,1260,1046,2306
2,KECAMATAN,55805,BIBOKI MOENLEU,1426,1498,2924
2,KECAMATAN,55734,MUTIS,1030,1877,2907
2,KECAMATAN,55727,MUSI,515,1645,2160
2,KECAMATAN,55633,MIOMAFO BARAT,2102,4818,6920
2,KECAMATAN,55646,BIBOKI SELATAN,1721,1771,3492
2,KECAMATAN,55655,NOEMUTI,1248,4561,5809
2,KECAMATAN,55668,KOTA KEFAMENANU,9860,10179,20039
2,KECAMATAN,55678,BIBOKI UTARA,2434,1994,4428
2,KECAMATAN,55686,BIBOKI ANLEU,2905,3429,6334
2,KECAMATAN,55696,INSANA,2973,5449,8422
2,KECAMATAN,55710,INSANA UTARA,1351,2748,4099
2,KECAMATAN,55716,NOEMUTI TIMUR,534,1456,1990
2,KECAMATAN,55721,MIOMAFFO TENGAH,1224,1519,2743
2,KECAMATAN,55813,BIBOKI FEOTLEU,898,845,1743
1,KABUPATEN/KOTA,55819,BELU,44956,63390,108346
2,KECAMATAN,55820,LAMAKNEN,3065,1912,4977
2,KECAMATAN,55962,LAEN MANEN,973,3719,4692
2,KECAMATAN,55972,WEWIKU,1634,5143,6777
2,KECAMATAN,55985,WELIMAN,1599,5422,7021
2,KECAMATAN,56000,LASIOLAT,1041,1826,2867
2,KECAMATAN,56008,LAMAKNEN SELATAN,1023,1938,2961
2,KECAMATAN,56017,IO KUFEU,1104,2115,3219
2,KECAMATAN,56025,BOTIN LEO BELE,596,1339,1935
2,KECAMATAN,56031,ATAMBUA BARAT,4030,4922,8952
2,KECAMATAN,56036,ATAMBUA SELATAN,5209,4914,10123
2,KECAMATAN,56041,NANAET DUABESI,601,1016,1617
2,KECAMATAN,55952,RAIMANUK,2527,3086,5613
2,KECAMATAN,55947,KOTA ATAMBUA,7072,4497,11569
2,KECAMATAN,55830,TASIFETOTIMUR,5595,3965,9560
2,KECAMATAN,55843,RAIHAT,3932,1684,5616
2,KECAMATAN,55850,TASIFETO BARAT,4421,4315,8736
2,KECAMATAN,55859,KAKULUK MESAK,5591,2679,8270
2,KECAMATAN,55866,MALAKA TIMUR,1353,2508,3861
2,KECAMATAN,55873,KOBALIMA,3864,3187,7051
2,KECAMATAN,55882,MALAKA TENGAH,5237,9300,14537
2,KECAMATAN,55900,SASITAMEAN,838,2660,3498
2,KECAMATAN,55910,MALAKA BARAT,1851,6446,8297
2,KECAMATAN,55927,RINHAT,2106,3369,5475
2,KECAMATAN,56046,KOBALIMA TIMUR,1306,1026,2332
1,KABUPATEN/KOTA,56051,ALOR,66568,82988,149556
2,KECAMATAN,56052,TELUK MUTIARA,13512,11536,25048
2,KECAMATAN,56225,PANTAR TENGAH,2925,1941,4866
2,KECAMATAN,56218,LEMBUR,709,1626,2335
2,KECAMATAN,56206,PANTAR TIMUR,2674,2910,5584
2,KECAMATAN,56201,PUREMAN,328,1257,1585
2,KECAMATAN,56193,MATARU,1104,1836,2940
2,KECAMATAN,56186,PULAU PURA,1027,1732,2759
2,KECAMATAN,56180,KABOLA,1675,2521,4196
2,KECAMATAN,56172,PANTAR BARAT,2300,902,3202
2,KECAMATAN,56163,ALOR TIMUR LAUT,1107,3082,4189
2,KECAMATAN,56148,ALOR TENGAH UTARA,2169,3456,5625
2,KECAMATAN,56136,PANTAR,2907,1884,4791
2,KECAMATAN,56125,ALOR TIMUR,0,0,0
2,KECAMATAN,56110,ALOR SELATAN,0,0,0
2,KECAMATAN,56089,ALOR BARAT DAYA,4136,6653,10789
2,KECAMATAN,56069,ALOR BARAT LAUT,6511,4020,10531
2,KECAMATAN,56236,PANTAR BARAT LAUT,1376,905,2281
1,KABUPATEN/KOTA,56244,FLORES TIMUR,44460,46261,90721
2,KECAMATAN,56245,WULANGGITANG,771,5693,6464
2,KECAMATAN,56476,ADONARA TENGAH,1076,3948,5024
2,KECAMATAN,56468,ADONARA,1702,2929,4631
2,KECAMATAN,56462,ILE BURA,373,2842,3215
2,KECAMATAN,56454,LEWOLEMA,728,3337,4065
2,KECAMATAN,56447,DEMON PAGONG,234,2222,2456
2,KECAMATAN,56426,ILE BOLENG,1364,5491,6855
2,KECAMATAN,56412,WITIHAMA,985,6830,7815
2,KECAMATAN,56399,KELUBAGOLIT,1121,4650,5771
2,KECAMATAN,56379,ADONARA TIMUR,4819,6765,11584
2,KECAMATAN,56366,WOTAN ULUMANDO,802,2792,3594
2,KECAMATAN,56349,ADONARA BARAT,1233,4314,5547
2,KECAMATAN,56329,SOLOR TIMUR,3524,2406,5930
2,KECAMATAN,56310,SOLOR BARAT,679,3673,4352
2,KECAMATAN,56295,TANJUNG BUNGA,911,4830,5741
2,KECAMATAN,56286,ILE MANDIRI,681,4161,4842
2,KECAMATAN,56269,LARANTUKA,4811,12877,17688
2,KECAMATAN,56256,TITEHENA,1035,4651,5686
2,KECAMATAN,83886,SOLOR SELATAN,268,2039,2307
1,KABUPATEN/KOTA,56489,SIKKA,27117,86450,113567
2,KECAMATAN,56490,PAGA,1139,6066,7205
2,KECAMATAN,56601,WAIBLAMA,859,2495,3354
2,KECAMATAN,56608,ALOK BARAT,2459,5280,7739
2,KECAMATAN,56613,ALOK TIMUR,5088,9300,14388
2,KECAMATAN,56624,KOTING,621,2932,3553
2,KECAMATAN,56631,TANA WAWO,966,3236,4202
2,KECAMATAN,56640,HEWOKLOANG,615,3370,3985
2,KECAMATAN,56648,KANGAE,2104,6064,8168
2,KECAMATAN,56658,DORENG,871,3749,4620
2,KECAMATAN,56595,MAGEPANDA,867,4492,5359
2,KECAMATAN,56588,BOLA,1092,4041,5133
2,KECAMATAN,56579,KEWAPANTE,1406,4729,6135
2,KECAMATAN,56499,MEGO,937,4528,5465
2,KECAMATAN,56510,LELA,661,5257,5918
2,KECAMATAN,56520,NITA,1177,9850,11027
2,KECAMATAN,56533,ALOK,3735,10479,14214
2,KECAMATAN,56541,PALUE,479,3490,3969
2,KECAMATAN,56550,NELLE,507,2643,3150
2,KECAMATAN,56556,TALIBURA,2845,6288,9133
2,KECAMATAN,56569,WAIGETE,1627,7910,9537
2,KECAMATAN,56666,MAPITARA,322,2712,3034
1,KABUPATEN/KOTA,56671,ENDE,30377,108911,139288
2,KECAMATAN,56672,NANGAPANDA,3396,7971,11367
2,KECAMATAN,56835,KOTA BARU,513,4048,4561
2,KECAMATAN,56848,KELIMUTU,350,3033,3383
2,KECAMATAN,56857,DETUKELI,435,2541,2976
2,KECAMATAN,56871,NDONA TIMUR,296,2008,2304
2,KECAMATAN,56878,NDORI,1415,1152,2567
2,KECAMATAN,56884,ENDE UTARA,4259,4501,8760
2,KECAMATAN,56892,ENDE TENGAH,3316,9188,12504
2,KECAMATAN,56897,ENDE TIMUR,2832,7081,9913
2,KECAMATAN,56826,LIO TIMUR,574,2774,3348
2,KECAMATAN,56815,MAUKARO,452,2953,3405
2,KECAMATAN,56805,MAUROLE,961,3990,4951
2,KECAMATAN,56691,PULAU ENDE,3213,1027,4240
2,KECAMATAN,56699,ENDE,908,7647,8555
2,KECAMATAN,56718,ENDE SELATAN,7877,4510,12387
2,KECAMATAN,56724,NDONA,1621,5545,7166
2,KECAMATAN,56739,DETUSOKO,513,6460,6973
2,KECAMATAN,56764,WEWARIA,1373,7010,8383
2,KECAMATAN,56782,WOLOWARU,2838,5010,7848
2,KECAMATAN,56798,WOLOJITA,496,2731,3227
2,KECAMATAN,83887,LEPEMBUSU KELISOKE,341,2231,2572
1,KABUPATEN/KOTA,56904,NGADA,37979,93411,131390
2,KECAMATAN,56905,AIMERE,1232,2877,4109
2,KECAMATAN,83542,GOLEWA BARAT,1568,2604,4172
2,KECAMATAN,83541,GOLEWA SELATAN,1381,3449,4830
2,KECAMATAN,57003,WOLOMEZE,630,1993,2623
2,KECAMATAN,56995,BAJAWA UTARA,1091,2697,3788
2,KECAMATAN,56988,RIUNG BARAT,1466,2087,3553
2,KECAMATAN,56979,JEREBUU,663,2482,3145
2,KECAMATAN,56966,RIUNG,2459,4068,6527
2,KECAMATAN,56958,SOA,2551,3622,6173
2,KECAMATAN,56940,BAJAWA,4962,11058,16020
2,KECAMATAN,56918,GOLEWA,1544,6114,7658
2,KECAMATAN,83543,INERIE,796,2509,3305
1,KABUPATEN/KOTA,57008,MANGGARAI,20343,45560,65903
2,KECAMATAN,57009,WAE RII,2685,9469,12154
2,KECAMATAN,83544,REOK BARAT,1764,4548,6312
2,KECAMATAN,57158,LELAK,970,3989,4959
2,KECAMATAN,57145,RAHONG UTARA,2247,6514,8761
2,KECAMATAN,57124,SATAR MESE BARAT,3566,9561,13127
2,KECAMATAN,57112,LANGKE REMBONG,8209,21318,29527
2,KECAMATAN,57091,REOK,3439,5436,8875
2,KECAMATAN,57063,CIBAL,2833,8776,11609
2,KECAMATAN,57043,SATAR MESE,3392,9395,12787
2,KECAMATAN,57026,RUTENG,3454,13886,17340
2,KECAMATAN,83545,CIBAL BARAT,1469,4460,5929
1,KABUPATEN/KOTA,57167,SUMBA TIMUR,34028,97352,131380
2,KECAMATAN,57168,KOTA WAINGAPU,0,0,0
2,KECAMATAN,57273,KARERA,976,2485,3461
2,KECAMATAN,57281,KAHAUNGU ETI,1074,2576,3650
2,KECAMATAN,57291,MATAWAI LA PAWU,589,1798,2387
2,KECAMATAN,57298,KAMBERA,3417,11945,15362
2,KECAMATAN,57307,KAMBATA MAPAMBUHANG,466,1242,1708
2,KECAMATAN,57314,LEWA TIDAHU,648,2139,2787
2,KECAMATAN,57321,KATALA HAMU LINGU,380,1309,1689
2,KECAMATAN,57327,KANATANG,898,3001,3899
2,KECAMATAN,57333,NGADU NGALA,0,0,0
2,KECAMATAN,57265,PABERIWAI,0,0,0
2,KECAMATAN,57257,WULLA WAIJELU,0,0,0
2,KECAMATAN,57176,HAHARU,644,1715,2359
2,KECAMATAN,57184,LEWA,1620,4827,6447
2,KECAMATAN,57193,NGGAHA ORI ANGU,1124,2702,3826
2,KECAMATAN,57202,TABUNDUNG,1195,2919,4114
2,KECAMATAN,57213,PINU PAHAR,869,2494,3363
2,KECAMATAN,57220,PANDAWAI,0,0,0
2,KECAMATAN,57228,UMALULU,0,0,0
2,KECAMATAN,57239,RINDI,1428,2756,4184
2,KECAMATAN,57248,PAHUNGA LODU,1938,3692,5630
2,KECAMATAN,57339,MAHU,0,0,0
1,KABUPATEN/KOTA,57346,SUMBA BARAT,17266,47600,64866
2,KECAMATAN,57347,TANA RIGHU,1253,5860,7113
2,KECAMATAN,57359,LOLI,3456,7113,10569
2,KECAMATAN,57368,WANOKAKA,1736,4501,6237
2,KECAMATAN,57379,LAMBOYA,1860,4630,6490
2,KECAMATAN,57389,KOTA WAIKABUBAK,4389,7931,12320
2,KECAMATAN,57401,LABOYA BARAT,897,2089,2986
1,KABUPATEN/KOTA,57406,LEMBATA,13591,32124,45715
2,KECAMATAN,57407,NAGA WUTUNG,0,0,0
2,KECAMATAN,57422,ATADEI,0,0,0
2,KECAMATAN,57438,ILE APE,0,0,0
2,KECAMATAN,57455,LEBATUKAN,0,0,0
2,KECAMATAN,57473,NUBATUKAN,0,0,0
2,KECAMATAN,57491,OMESURI,0,0,0
2,KECAMATAN,57513,BUYASURI,0,0,0
2,KECAMATAN,57534,WULANDONI,0,0,0
2,KECAMATAN,57550,ILE APE TIMUR,0,0,0
1,KABUPATEN/KOTA,57560,ROTE NDAO,0,0,0
2,KECAMATAN,57561,ROTE BARAT DAYA,1371,7588,8959
2,KECAMATAN,83546,NDAO NUSE,161,1328,1489
2,KECAMATAN,57643,ROTE  SELATAN,658,1780,2438
2,KECAMATAN,57634,ROTE BARAT,804,2572,3376
2,KECAMATAN,57623,ROTE TIMUR,1543,4457,6000
2,KECAMATAN,57611,PANTAI BARU,1092,4933,6025
2,KECAMATAN,57603,ROTE TENGAH,1226,2459,3685
2,KECAMATAN,57588,LOBALAIN,2279,10009,12288
2,KECAMATAN,57575,ROTE BARAT LAUT,2016,7978,9994
2,KECAMATAN,83547,LANDU LEKO,712,1378,2090
1,KABUPATEN/KOTA,57649,MANGGARAI BARAT,11862,44482,56344
2,KECAMATAN,57650,MACANG PACAR,1776,11692,13468
2,KECAMATAN,83549,LEMBOR SELATAN,3628,6945,10573
2,KECAMATAN,83548,NDOSO,1826,8086,9912
2,KECAMATAN,57766,WELAK,2019,8054,10073
2,KECAMATAN,57756,BOLENG,3227,6077,9304
2,KECAMATAN,57739,KOMODO,8090,11996,20086
2,KECAMATAN,57714,SANO NGGOANG,1781,4270,6051
2,KECAMATAN,57692,LEMBOR,4283,10726,15009
2,KECAMATAN,57664,KUWUS,2813,9559,12372
2,KECAMATAN,83550,MBELILING,1637,4411,6048
1,KABUPATEN/KOTA,57778,NAGEKEO,31080,81816,112896
2,KECAMATAN,57779,AESESA,3131,13398,16529
2,KECAMATAN,57798,NANGARORO,1049,8201,9250
2,KECAMATAN,57814,BOAWAE,1647,14469,16116
2,KECAMATAN,57838,MAUPONGGO,1479,9386,10865
2,KECAMATAN,57859,WOLOWAE,360,2109,2469
2,KECAMATAN,57865,KEO TENGAH,667,6481,7148
2,KECAMATAN,57880,AESESA SELATAN,295,2382,2677
1,KABUPATEN/KOTA,57886,SUMBA TENGAH,8628,56426,65054
2,KECAMATAN,57887,KATIKU TANA,0,0,0
2,KECAMATAN,57893,UMBU RATU NGGAY BARAT,0,0,0
2,KECAMATAN,57905,MAMBORO,0,0,0
2,KECAMATAN,57915,UMBU RATU NGGAY,0,0,0
2,KECAMATAN,57927,KATIKU TANA SELATAN,0,0,0
1,KABUPATEN/KOTA,57935,SUMBA BARAT DAYA,0,0,0
2,KECAMATAN,57936,LOURA,1191,5726,6917
2,KECAMATAN,83552,WEWEWA TENGAH,10088,13276,23364
2,KECAMATAN,83551,KOTA TAMBOLAKA,3045,9933,12978
2,KECAMATAN,58027,KODI UTARA,2744,21582,24326
2,KECAMATAN,58015,KODI,2417,16285,18702
2,KECAMATAN,58001,KODI BANGEDO,2692,10449,13141
2,KECAMATAN,57992,WEWEWA SELATAN,5303,5936,11239
2,KECAMATAN,57977,WEWEWA BARAT,10160,16705,26865
2,KECAMATAN,57956,WEWEWA TIMUR,6599,9111,15710
2,KECAMATAN,57949,WEWEWA UTARA,4180,6384,10564
2,KECAMATAN,83553,KODI BALAGHAR,2177,3791,5968
1,KABUPATEN/KOTA,58098,MANGGARAI TIMUR,50596,119178,169774
2,KECAMATAN,58099,BORONG,0,0,0
2,KECAMATAN,58121,POCO RANAKA,0,0,0
2,KECAMATAN,58150,LAMBA LEDA,0,0,0
2,KECAMATAN,58167,SAMBI RAMPAS,0,0,0
2,KECAMATAN,58179,ELAR,0,0,0
2,KECAMATAN,58201,KOTA KOMBA,0,0,0
2,KECAMATAN,83554,RANA MESE,0,0,0
2,KECAMATAN,83555,POCO RANAKA TIMUR,0,0,0
2,KECAMATAN,83556,ELAR SELATAN,0,0,0
1,KABUPATEN/KOTA,58219,SABU RAIJUA,0,0,0
2,KECAMATAN,58220,SABU BARAT,0,0,0
2,KECAMATAN,58237,SABU TENGAH,0,0,0
2,KECAMATAN,58245,SABU TIMUR,0,0,0
2,KECAMATAN,58261,SABU LIAE,0,0,0
2,KECAMATAN,58270,HAWU MEHARA,0,0,0
2,KECAMATAN,58279,RAIJUA,0,0,0
1,KABUPATEN/KOTA,58040,KOTA KUPANG,0,0,0
2,KECAMATAN,58041,ALAK,0,0,0
2,KECAMATAN,58054,MAULAFA,0,0,0
2,KECAMATAN,58064,KELAPA LIMA,0,0,0
2,KECAMATAN,58070,OEBOBO,0,0,0
2,KECAMATAN,58079,KOTA RAJA,0,0,0
2,KECAMATAN,58087,KOTA LAMA,0,0,0
0,PROVINSI,58285,KALIMANTAN BARAT,0,0,0
1,KABUPATEN/KOTA,58286,SAMBAS,0,0,0
2,KECAMATAN,58287,SAMBAS,12143,12524,24667
2,KECAMATAN,58479,SALATIGA,3294,4748,8042
2,KECAMATAN,58471,TANGARAN,6152,4870,11022
2,KECAMATAN,58461,JAWAI SELATAN,3803,5271,9074
2,KECAMATAN,58453,SEBAWI,3584,4732,8316
2,KECAMATAN,58448,SAJAD,1764,3262,5026
2,KECAMATAN,58442,SEMPARUK,6175,6990,13165
2,KECAMATAN,58434,TEKARANG,3597,3940,7537
2,KECAMATAN,58423,GALING,4933,7066,11999
2,KECAMATAN,58411,SUBAH,3498,7953,11451
2,KECAMATAN,58405,SAJINGAN BESAR,549,5406,5955
2,KECAMATAN,58396,PALOH,5078,7186,12264
2,KECAMATAN,58386,SELAKAU,6291,8821,15112
2,KECAMATAN,58373,SEJANGKUNG,4745,6427,11172
2,KECAMATAN,58367,PEMANGKAT,7989,14105,22094
2,KECAMATAN,58343,TEBAS,12993,21819,34812
2,KECAMATAN,58331,JAWAI,8663,9338,18001
2,KECAMATAN,58306,TELUK KERAMAT,15253,17614,32867
2,KECAMATAN,58485,SELAKAU TIMUR,2315,2931,5246
1,KABUPATEN/KOTA,58490,PONTIANAK,112819,155003,267822
2,KECAMATAN,58491,MEMPAWAH HILIR,13070,5145,18215
2,KECAMATAN,58500,TOHO,2366,7692,10058
2,KECAMATAN,58509,SUNGAI PINYUH,15483,9330,24813
2,KECAMATAN,58519,SIANTAN,12876,8091,20967
2,KECAMATAN,58525,SUNGAI KUNYIT,7486,4056,11542
2,KECAMATAN,58538,SEGEDONG,6245,3888,10133
2,KECAMATAN,58545,ANJONGAN,4912,3985,8897
2,KECAMATAN,58551,SADANIANG,503,5130,5633
2,KECAMATAN,58558,MEMPAWAH TIMUR,10554,2530,13084
1,KABUPATEN/KOTA,58567,SANGGAU,73495,49847,123342
2,KECAMATAN,58568,KAPUAS,20954,27512,48466
2,KECAMATAN,58724,MELIAU,10149,17941,28090
2,KECAMATAN,58716,TOBA,793,7217,8010
2,KECAMATAN,58703,BALAI,1869,12864,14733
2,KECAMATAN,58687,TAYAN HILIR,5818,13020,18838
2,KECAMATAN,58675,TAYAN HULU,3146,17721,20867
2,KECAMATAN,58660,PARINDU,2581,18821,21402
2,KECAMATAN,58648,KEMBAYAN,3977,13693,17670
2,KECAMATAN,58637,SEKAYAM,5367,11957,17324
2,KECAMATAN,58631,BEDUAI,1385,5339,6724
2,KECAMATAN,58621,BONTI,3037,10728,13765
2,KECAMATAN,58609,JANGKANG,2209,14450,16659
2,KECAMATAN,58603,NOYAN,454,5709,6163
2,KECAMATAN,58594,MUKOK,4080,6951,11031
2,KECAMATAN,58743,ENTIKONG,1853,7297,9150
1,KABUPATEN/KOTA,58749,KETAPANG,67672,191220,258892
2,KECAMATAN,58750,MATAN HILIR UTARA,3674,3535,7209
2,KECAMATAN,58931,BENUA KAYONG,14965,4811,19776
2,KECAMATAN,58943,DELTA PAWAN,20416,14981,35397
2,KECAMATAN,58953,MUARA PAWAN,4103,3009,7112
2,KECAMATAN,58962,SIMPANG DUA,429,4856,5285
2,KECAMATAN,58968,SINGKUP,1442,2336,3778
2,KECAMATAN,58977,AIR UPAS,1968,7882,9850
2,KECAMATAN,58987,HULU SUNGAI,516,6185,6701
2,KECAMATAN,59000,PEMAHAN,1152,1356,2508
2,KECAMATAN,58911,JELAI HULU,1634,8185,9819
2,KECAMATAN,58885,TUMBANG TITI,3304,8678,11982
2,KECAMATAN,58756,MARAU,1279,6723,8002
2,KECAMATAN,58767,MANIS MATA,4662,10735,15397
2,KECAMATAN,58787,KENDAWANGAN,5207,12565,17772
2,KECAMATAN,58807,SANDAI,5488,8770,14258
2,KECAMATAN,58820,SUNGAI LAUR,3178,7265,10443
2,KECAMATAN,58839,SIMPANG HULU,1491,17594,19085
2,KECAMATAN,58854,NANGA TAYAP,6038,10097,16135
2,KECAMATAN,58873,MATAN HILIR SELATAN,8604,5894,14498
2,KECAMATAN,59006,SUNGAI MELAYU RAYAK,2340,4687,7027
1,KABUPATEN/KOTA,59018,SINTANG,91890,150144,242034
2,KECAMATAN,59019,SINTANG,23222,16480,39702
2,KECAMATAN,59286,SUNGAI TEBELIAN,6573,10767,17340
2,KECAMATAN,59269,KELAM PERMAI,2017,8265,10282
2,KECAMATAN,59255,AMBALAU,1243,7422,8665
2,KECAMATAN,59230,SERAWAI,3297,9761,13058
2,KECAMATAN,59200,KAYAN HULU,5029,12707,17736
2,KECAMATAN,59173,KAYAN HILIR,3406,16144,19550
2,KECAMATAN,59152,DEDAI,7128,11680,18808
2,KECAMATAN,59133,KETUNGAU HULU,1697,10234,11931
2,KECAMATAN,59112,KETUNGAU TENGAH,1787,15700,17487
2,KECAMATAN,59094,KETUNGAU HILIR,1712,11590,13302
2,KECAMATAN,59060,SEPAUK,7129,22776,29905
2,KECAMATAN,59035,TEMPUNAK,4008,13032,17040
2,KECAMATAN,59308,BINJAI HULU,2607,4081,6688
1,KABUPATEN/KOTA,59320,KAPUAS HULU,70855,170639,241494
2,KECAMATAN,59321,PUTUSSIBAU UTARA,4717,9033,13750
2,KECAMATAN,59454,BADAU,984,2441,3425
2,KECAMATAN,59464,SILAT HILIR,2468,7182,9650
2,KECAMATAN,59476,SILAT HULU,2031,4817,6848
2,KECAMATAN,59488,PUTUSSIBAU SELATAN,4301,7411,11712
2,KECAMATAN,59505,KALIS,1659,6384,8043
2,KECAMATAN,59517,BOYAN TANJUNG,2880,3100,5980
2,KECAMATAN,59526,MENTEBAH,1715,3057,4772
2,KECAMATAN,59532,PENGKADAN,2619,2253,4872
2,KECAMATAN,59541,SUHAID,1309,3371,4680
2,KECAMATAN,59447,EMPANANG,201,1940,2141
2,KECAMATAN,59437,BATANG LUPAR,635,2214,2849
2,KECAMATAN,59425,SEBERUANG,436,6004,6440
2,KECAMATAN,59336,BIKA,251,2294,2545
2,KECAMATAN,59345,EMBALOH HILIR,727,2298,3025
2,KECAMATAN,59355,EMBALOH HULU,220,2492,2712
2,KECAMATAN,59366,BUNUT HILIR,2094,3057,5151
2,KECAMATAN,59375,BUNUT HULU,4033,3440,7473
2,KECAMATAN,59383,JONGKONG,3214,2734,5948
2,KECAMATAN,59392,HULU GURUNG,5534,2626,8160
2,KECAMATAN,59402,SELIMBAU,2336,4955,7291
2,KECAMATAN,59416,SEMITAU,878,3995,4873
2,KECAMATAN,59551,PURING KENCANA,104,1236,1340
1,KABUPATEN/KOTA,59557,BENGKAYANG,45346,88334,133680
2,KECAMATAN,59558,SUNGAI RAYA,4666,5208,9874
2,KECAMATAN,59685,LEMBAH BAWANG,501,2366,2867
2,KECAMATAN,59679,SUNGAI RAYA KEPULAUAN,5406,5192,10598
2,KECAMATAN,59674,SUNGAI BETUNG,508,4268,4776
2,KECAMATAN,59668,LUMAR,462,3383,3845
2,KECAMATAN,59659,SIDING,363,2727,3090
2,KECAMATAN,59652,CAPKALA,793,3111,3904
2,KECAMATAN,59643,SUTI SEMARANG,617,2562,3179
2,KECAMATAN,59624,TERIAK,850,7423,8273
2,KECAMATAN,59612,MONTERADO,3363,10207,13570
2,KECAMATAN,59605,JAGOI BABANG,803,3616,4419
2,KECAMATAN,59599,SANGGAU LEDO,2242,4272,6514
2,KECAMATAN,59592,SELUAS,2211,6125,8336
2,KECAMATAN,59585,BENGKAYANG,2540,10584,13124
2,KECAMATAN,59572,LEDO,1271,5846,7117
2,KECAMATAN,59564,SAMALANTAN,1606,9796,11402
2,KECAMATAN,59694,TUJUH BELAS,2524,4740,7264
1,KABUPATEN/KOTA,59699,LANDAK,30726,91426,122152
2,KECAMATAN,59700,NGABANG,9248,31249,40497
2,KECAMATAN,59853,BANYUKE HULU,781,7877,8658
2,KECAMATAN,59839,JELIMPO,2358,15321,17679
2,KECAMATAN,59833,SEBANGKI,5394,6104,11498
2,KECAMATAN,59821,KUALA BEHE,2280,8409,10689
2,KECAMATAN,59814,MERANTI,1057,5511,6568
2,KECAMATAN,59799,SENGAH TEMILA,3991,35825,39816
2,KECAMATAN,59782,MENYUKE,2869,16176,19045
2,KECAMATAN,59765,AIR BESAR,2864,13136,16000
2,KECAMATAN,59747,MANDOR,2831,14278,17109
2,KECAMATAN,59738,MENJALIN,1025,10957,11982
2,KECAMATAN,59720,MEMPAWAH HULU,1932,21359,23291
2,KECAMATAN,59861,SOMPAK,993,9408,10401
1,KABUPATEN/KOTA,59869,SEKADAU,37623,195610,233233
2,KECAMATAN,59870,SEKADAU HILIR,12641,21454,34095
2,KECAMATAN,59885,SEKADAU HULU,4095,12297,16392
2,KECAMATAN,59900,NANGA TAMAN,3275,12587,15862
2,KECAMATAN,59913,NANGA MAHAP,3381,10754,14135
2,KECAMATAN,59925,BELITANG HILIR,3630,10303,13933
2,KECAMATAN,59934,BELITANG HULU,1493,12457,13950
2,KECAMATAN,59947,BELITANG,2481,4461,6942
1,KABUPATEN/KOTA,59953,MELAWI,30996,84313,115309
2,KECAMATAN,59954,BELIMBING,4538,9771,14309
2,KECAMATAN,60110,PINOH SELATAN,3435,4892,8327
2,KECAMATAN,60090,PINOH UTARA,5578,5918,11496
2,KECAMATAN,60081,BELIMBING HULU,2220,4734,6954
2,KECAMATAN,60062,SOKAN,6034,6901,12935
2,KECAMATAN,60049,TANAH PINOH,6332,4771,11103
2,KECAMATAN,60030,SAYAN,5289,7942,13231
2,KECAMATAN,60010,MENUKUNG,3162,10427,13589
2,KECAMATAN,59990,ELLA HILIR,4788,6729,11517
2,KECAMATAN,59972,NANGA PINOH,15066,11774,26840
2,KECAMATAN,60123,TANAH PINOH BARAT,2908,7371,10279
1,KABUPATEN/KOTA,60134,KAYONG UTARA,59350,81230,140580
2,KECAMATAN,60135,SUKADANA,7391,4448,11839
2,KECAMATAN,60146,SIMPANG HILIR,7403,6403,13806
2,KECAMATAN,60159,TELUK BATANG,4752,3424,8176
2,KECAMATAN,60167,PULAU MAYA,3566,2426,5992
2,KECAMATAN,60176,SEPONTI,2559,3082,5641
2,KECAMATAN,83729,KEPULAUAN KARIMATA,632,886,1518
1,KABUPATEN/KOTA,60255,KUBU RAYA,26303,20669,46972
2,KECAMATAN,60256,SUNGAI RAYA,57329,47012,104341
2,KECAMATAN,60271,KUALA MANDOR B,10661,3869,14530
2,KECAMATAN,60277,SUNGAI AMBAWANG,24972,16621,41593
2,KECAMATAN,60291,TERENTANG,2689,2688,5377
2,KECAMATAN,60301,BATU AMPAR,9131,6180,15311
2,KECAMATAN,60316,KUBU,10737,8158,18895
2,KECAMATAN,60336,RASAU JAYA,6735,6637,13372
2,KECAMATAN,60343,TELUK PAKEDAI,5388,3201,8589
2,KECAMATAN,60358,SUNGAI KAKAP,35781,18500,54281
1,KABUPATEN/KOTA,60183,KOTA PONTIANAK,163423,112866,276289
2,KECAMATAN,60184,PONTIANAK SELATAN,19200,27249,46449
2,KECAMATAN,60190,PONTIANAK TIMUR,31481,12740,44221
2,KECAMATAN,60198,PONTIANAK BARAT,45640,22915,68555
2,KECAMATAN,60203,PONTIANAK UTARA,34513,29021,63534
2,KECAMATAN,60208,PONTIANAK KOTA,37525,25009,62534
2,KECAMATAN,60214,PONTIANAK TENGGARA,14293,9343,23636
1,KABUPATEN/KOTA,60223,KOTA SINGKAWANG,182652,126277,308929
2,KECAMATAN,60224,SINGKAWANG TENGAH,17577,12370,29947
2,KECAMATAN,60231,SINGKAWANG BARAT,6243,15843,22086
2,KECAMATAN,60236,SINGKAWANG TIMUR,2089,7834,9923
2,KECAMATAN,60242,SINGKAWANG UTARA,7189,5517,12706
2,KECAMATAN,60250,SINGKAWANG SELATAN,6107,14026,20133
0,PROVINSI,60371,KALIMANTAN TENGAH,0,0,0
1,KABUPATEN/KOTA,60372,KOTAWARINGIN BARAT,39205,55590,94795
2,KECAMATAN,60373,KUMAI,14631,10152,24783
2,KECAMATAN,60391,ARUT SELATAN,27766,25190,52956
2,KECAMATAN,60412,KOTAWARINGIN LAMA,4206,5724,9930
2,KECAMATAN,60430,ARUT UTARA,1589,3886,5475
2,KECAMATAN,60442,PANGKALAN LADA,6837,10940,17777
2,KECAMATAN,60454,PANGKALAN BANTENG,6264,9349,15613
1,KABUPATEN/KOTA,60468,KOTAWARINGIN TIMUR,61293,65241,126534
2,KECAMATAN,60469,KOTA BESI,0,0,0
2,KECAMATAN,83681,TUALAN HULU,0,0,0
2,KECAMATAN,60638,BUKIT SANTUAI,0,0,0
2,KECAMATAN,60631,TELAWANG,0,0,0
2,KECAMATAN,60620,CEMPAGA HULU,0,0,0
2,KECAMATAN,60614,SERANAU,0,0,0
2,KECAMATAN,60609,TELUK SAMPIT,0,0,0
2,KECAMATAN,60578,ANTANG KALANG,0,0,0
2,KECAMATAN,60567,PULAU HANAUT,0,0,0
2,KECAMATAN,60556,MENTAYA HILIR SELATAN,0,0,0
2,KECAMATAN,60548,MENTAYA HILIR UTARA,0,0,0
2,KECAMATAN,60539,MENTAWA BARU KETAPANG,0,0,0
2,KECAMATAN,60532,BAAMANG,0,0,0
2,KECAMATAN,60507,PARENGGEAN,0,0,0
2,KECAMATAN,60490,MENTAYA HULU,0,0,0
2,KECAMATAN,60481,CEMPAGA,0,0,0
2,KECAMATAN,83683,TELAGA ANTANG,0,0,0
1,KABUPATEN/KOTA,60653,KAPUAS,0,0,0
2,KECAMATAN,60654,SELAT,20087,11276,31363
2,KECAMATAN,83696,DADAHUP,2394,3114,5508
2,KECAMATAN,83695,MANDAU TALAWANG,271,2139,2410
2,KECAMATAN,83693,PASAK TALAWANG,604,2399,3003
2,KECAMATAN,83689,TAMBAN CATUR,3191,3654,6845
2,KECAMATAN,60846,KAPUAS HULU,535,4208,4743
2,KECAMATAN,60825,KAPUAS TENGAH,1039,5480,6519
2,KECAMATAN,60815,TIMPAH,988,3298,4286
2,KECAMATAN,60783,MANTANGAI,6179,9578,15757
2,KECAMATAN,60768,BASARANG,4827,3812,8639
2,KECAMATAN,60731,KAPUAS MURUNG,6091,5793,11884
2,KECAMATAN,60722,PULAU PETAK,5036,3795,8831
2,KECAMATAN,60710,KAPUAS BARAT,4029,4389,8418
2,KECAMATAN,60691,KAPUAS KUALA,4770,4539,9309
2,KECAMATAN,60683,KAPUAS TIMUR,7219,4399,11618
2,KECAMATAN,60674,KAPUAS HILIR,3084,3600,6684
2,KECAMATAN,83697,BATAGUH,7811,7929,15740
1,KABUPATEN/KOTA,60867,BARITO SELATAN,78155,83402,161557
2,KECAMATAN,60868,JENAMAS,1969,2254,4223
2,KECAMATAN,60874,DUSUN HILIR,3948,3551,7499
2,KECAMATAN,60885,KARAU KUALA,2584,4846,7430
2,KECAMATAN,60897,DUSUN UTARA,2150,5801,7951
2,KECAMATAN,60939,DUSUN SELATAN,12490,14068,26558
1,KABUPATEN/KOTA,60967,BARITO UTARA,23141,30520,53661
2,KECAMATAN,60968,MONTALLAT,0,0,0
2,KECAMATAN,60979,GUNUNG TIMANG,0,0,0
2,KECAMATAN,60996,GUNUNG PUREI,0,0,0
2,KECAMATAN,61008,TEWEH TIMUR,0,0,0
2,KECAMATAN,61024,TEWEH TENGAH,0,0,0
2,KECAMATAN,61052,LAHEI,0,0,0
2,KECAMATAN,83701,TEWEH BARU,0,0,0
2,KECAMATAN,83703,TEWEH SELATAN,0,0,0
2,KECAMATAN,83705,LAHEI BARAT,0,0,0
1,KABUPATEN/KOTA,61077,KATINGAN,0,0,0
2,KECAMATAN,61078,KAMIPANG,1133,1669,2802
2,KECAMATAN,61231,PETAK MALAI,269,1284,1553
2,KECAMATAN,61222,TASIK PAYAWAN,1403,2008,3411
2,KECAMATAN,61205,KATINGAN KUALA,4553,4998,9551
2,KECAMATAN,61197,MENDAWAI,1027,819,1846
2,KECAMATAN,61174,KATINGAN HULU,1026,2974,4000
2,KECAMATAN,61155,MARIKIT,571,2748,3319
2,KECAMATAN,61140,SANAMAN MANTIKEI,1167,4357,5524
2,KECAMATAN,61123,KATINGAN TENGAH,3673,8836,12509
2,KECAMATAN,61108,PULAU MALAN,1150,3049,4199
2,KECAMATAN,61097,TEWANG SANGALANG GARING,1268,4607,5875
2,KECAMATAN,61088,KATINGAN HILIR,4907,8912,13819
2,KECAMATAN,61239,BUKIT RAYA,448,1984,2432
1,KABUPATEN/KOTA,61251,SERUYAN,22595,48245,70840
2,KECAMATAN,61252,SERUYAN HILIR,6712,8441,15153
2,KECAMATAN,61342,BATU AMPAR,1546,3407,4953
2,KECAMATAN,61335,DANAU SELULUK,3470,7490,10960
2,KECAMATAN,61329,SERUYAN RAYA,2125,7681,9806
2,KECAMATAN,61322,SERUYAN HILIR TIMUR,1874,1703,3577
2,KECAMATAN,61301,SERUYAN HULU,1837,3671,5508
2,KECAMATAN,61293,HANAU,4827,5678,10505
2,KECAMATAN,61284,DANAU SEMBULUH,1999,3765,5764
2,KECAMATAN,61263,SERUYAN TENGAH,3573,9003,12576
2,KECAMATAN,61352,SULING TAMBUN,626,821,1447
1,KABUPATEN/KOTA,61362,SUKAMARA,28589,51660,80249
2,KECAMATAN,61363,SUKAMARA,4254,6648,10902
2,KECAMATAN,61372,JELAI,932,1224,2156
2,KECAMATAN,61378,BALAI RIAM,1218,2692,3910
2,KECAMATAN,61387,PANTAI LUNCI,1103,1295,2398
2,KECAMATAN,61392,PERMATA KECUBUNG,928,2340,3268
1,KABUPATEN/KOTA,61400,LAMANDAU,8435,14199,22634
2,KECAMATAN,61401,LAMANDAU,950,2110,3060
2,KECAMATAN,61412,DELANG,792,1965,2757
2,KECAMATAN,61423,BULIK,4014,6705,10719
2,KECAMATAN,61436,BULIK TIMUR,1279,2250,3529
2,KECAMATAN,61449,MENTHOBI RAYA,1565,3671,5236
2,KECAMATAN,61461,SEMATU JAYA,1811,4149,5960
2,KECAMATAN,61469,BELANTIKAN RAYA,979,1979,2958
2,KECAMATAN,61482,BATANG KAWA,349,1060,1409
1,KABUPATEN/KOTA,61492,GUNUNG MAS,11739,23889,35628
2,KECAMATAN,61493,KURUN,0,0,0
2,KECAMATAN,83718,RUNGAN BARAT,0,0,0
2,KECAMATAN,83716,SEPANG SIMIN,0,0,0
2,KECAMATAN,61607,MAHUNING RAYA,0,0,0
2,KECAMATAN,61595,RUNGAN HULU,0,0,0
2,KECAMATAN,61583,MIRI MANASA,0,0,0
2,KECAMATAN,61574,DAMANG BATU,0,0,0
2,KECAMATAN,61561,MANUHING,0,0,0
2,KECAMATAN,61539,RUNGAN,0,0,0
2,KECAMATAN,61526,KAHAYAN HULU UTARA,0,0,0
2,KECAMATAN,61509,TEWAH,0,0,0
2,KECAMATAN,83811,MIHING RAYA,0,0,0
1,KABUPATEN/KOTA,61614,PULANG PISAU,0,0,0
2,KECAMATAN,61615,PANDIH BATU,4552,6173,10725
2,KECAMATAN,61631,KAHAYAN KUALA,4174,3666,7840
2,KECAMATAN,61642,KAHAYAN TENGAH,685,3638,4323
2,KECAMATAN,61657,BANAMA TINGANG,0,0,0
2,KECAMATAN,61673,KAHAYAN HILIR,5700,7699,13399
2,KECAMATAN,61682,MALIKU,5122,6908,12030
2,KECAMATAN,61696,JABIREN,1401,2850,4251
2,KECAMATAN,61704,SEBANGAU KUALA,935,1758,2693
1,KABUPATEN/KOTA,61711,MURUNG RAYA,22569,32692,55261
2,KECAMATAN,61712,MURUNG,10398,5786,16184
2,KECAMATAN,61832,SERIBU RIAM,304,1233,1537
2,KECAMATAN,61825,SUNGAI BABUAT,218,1051,1269
2,KECAMATAN,61818,TANAH SIANG SELATAN,457,1732,2189
2,KECAMATAN,61806,BARITO TUHUP RAYA,759,1580,2339
2,KECAMATAN,61796,SUMBER BARITO,773,2111,2884
2,KECAMATAN,61783,PERMATA INTAN,2203,2582,4785
2,KECAMATAN,61756,LAUNG TUHUP,4228,3999,8227
2,KECAMATAN,61728,TANAH SIANG,1011,4467,5478
2,KECAMATAN,61840,UUT MURUNG,381,927,1308
1,KABUPATEN/KOTA,61846,BARITO TIMUR,20732,25468,46200
2,KECAMATAN,61847,DUSUN TIMUR,4528,8618,13146
2,KECAMATAN,61915,PAKU,910,3416,4326
2,KECAMATAN,61909,RAREN BATUAH,1395,2927,4322
2,KECAMATAN,61901,PAJU EPAT,996,1798,2794
2,KECAMATAN,61890,PEMATANG KARAU,3344,2984,6328
2,KECAMATAN,61883,DUSUN TENGAH,5297,6576,11873
2,KECAMATAN,61874,AWANG,710,2866,3576
2,KECAMATAN,61866,PATANGKEP TUTUI,880,2839,3719
2,KECAMATAN,61859,BANUA LIMA,1144,2278,3422
2,KECAMATAN,61921,KARUSEN JANANG,703,1750,2453
1,KABUPATEN/KOTA,61929,KOTA PALANGKARAYA,19907,36052,55959
2,KECAMATAN,61930,PAHANDUT,0,0,0
2,KECAMATAN,61937,BUKIT BATU,0,0,0
2,KECAMATAN,61945,JEKAN RAYA,0,0,0
2,KECAMATAN,61950,SABANGAU,0,0,0
2,KECAMATAN,61957,RAKUMPIT,0,0,0
0,PROVINSI,61965,KALIMANTAN SELATAN,0,0,0
1,KABUPATEN/KOTA,61966,TANAH LAUT,0,0,0
2,KECAMATAN,61967,TAKISUNG,0,0,0
2,KECAMATAN,62090,BAJUIN,0,0,0
2,KECAMATAN,62075,BATU AMPAR,0,0,0
2,KECAMATAN,62065,TAMBANG ULANG,0,0,0
2,KECAMATAN,62050,KINTAP,0,0,0
2,KECAMATAN,62039,PANYIPATAN,0,0,0
2,KECAMATAN,62024,BATI BATI,0,0,0
2,KECAMATAN,62012,KURAU,0,0,0
2,KECAMATAN,61991,PELAIHARI,0,0,0
2,KECAMATAN,61980,JORONG,0,0,0
2,KECAMATAN,62100,BUMI MAKMUR,0,0,0
1,KABUPATEN/KOTA,62112,KOTABARU,0,0,0
2,KECAMATAN,62113,PULAUSEMBILAN,0,0,0
2,KECAMATAN,62261,PAMUKAN UTARA,0,0,0
2,KECAMATAN,62275,HAMPANG,0,0,0
2,KECAMATAN,62284,SUNGAIDURIAN,0,0,0
2,KECAMATAN,62292,KELUMPANG BARAT,0,0,0
2,KECAMATAN,62299,PULAULAUT TENGAH,0,0,0
2,KECAMATAN,62307,PULAULAUT KEPULAUAN,0,0,0
2,KECAMATAN,62317,KELUMPANG HILIR,0,0,0
2,KECAMATAN,62327,PAMUKAN BARAT,0,0,0
2,KECAMATAN,62250,SAMPANAHAN,0,0,0
2,KECAMATAN,62238,PAMUKAN SELATAN,0,0,0
2,KECAMATAN,62230,KELUMPANG UTARA,0,0,0
2,KECAMATAN,62119,PULAULAUT BARAT,0,0,0
2,KECAMATAN,62141,PULAULAUT SELATAN,0,0,0
2,KECAMATAN,62149,PULAULAUT TIMUR,0,0,0
2,KECAMATAN,62164,PULAUSEBUKU,0,0,0
2,KECAMATAN,62173,PULAULAUT UTARA,0,0,0
2,KECAMATAN,62195,KELUMPANG SELATAN,0,0,0
2,KECAMATAN,62205,KELUMPANG HULU,0,0,0
2,KECAMATAN,62216,KELUMPANG TENGAH,0,0,0
2,KECAMATAN,83672,PULAULAUT TANJUNG SELAYAR,0,0,0
1,KABUPATEN/KOTA,62333,BANJAR,0,0,0
2,KECAMATAN,62334,ALUH ALUH,0,0,0
2,KECAMATAN,62624,TELAGA BAUNTUNG,0,0,0
2,KECAMATAN,62619,PARAMASAN,0,0,0
2,KECAMATAN,62611,SAMBUNG MAKMUR,0,0,0
2,KECAMATAN,62590,MARTAPURA TIMUR,0,0,0
2,KECAMATAN,62576,MARTAPURA BARAT,0,0,0
2,KECAMATAN,62563,BERUNTUNG BARU,0,0,0
2,KECAMATAN,62547,MATARAMAN,0,0,0
2,KECAMATAN,62534,ARANIO,0,0,0
2,KECAMATAN,62522,SUNGAI PINANG,0,0,0
2,KECAMATAN,62509,PENGAROM,0,0,0
2,KECAMATAN,62482,SIMPANG EMPAT,0,0,0
2,KECAMATAN,62459,ASTAMBUL,0,0,0
2,KECAMATAN,62432,KARANG INTAN,0,0,0
2,KECAMATAN,62405,MARTAPURA,0,0,0
2,KECAMATAN,62383,SUNGAI TABUK,0,0,0
2,KECAMATAN,62368,GAMBUT,0,0,0
2,KECAMATAN,62354,KERTAK HANYAR,0,0,0
2,KECAMATAN,62629,TATAH MAKMUR,0,0,0
1,KABUPATEN/KOTA,62643,BARITO KUALA,0,0,0
2,KECAMATAN,62644,TABUNGANEN,0,0,0
2,KECAMATAN,62839,WANARAYA,0,0,0
2,KECAMATAN,62829,MARABAHAN,0,0,0
2,KECAMATAN,62817,BARAMBAI,0,0,0
2,KECAMATAN,62807,MEKARSARI,0,0,0
2,KECAMATAN,62795,TABUKAN,0,0,0
2,KECAMATAN,62785,KURIPAN,0,0,0
2,KECAMATAN,62775,BAKUMPAI,0,0,0
2,KECAMATAN,62766,CERBON,0,0,0
2,KECAMATAN,62752,BELAWANG,0,0,0
2,KECAMATAN,62742,RANTAU BADAUH,0,0,0
2,KECAMATAN,62727,MANDASTANA,0,0,0
2,KECAMATAN,62708,ALALAK,0,0,0
2,KECAMATAN,62692,ANJIR MUARA,0,0,0
2,KECAMATAN,62676,ANJIR PASAR,0,0,0
2,KECAMATAN,62659,TAMBAN,0,0,0
2,KECAMATAN,62853,JEJANGKIT,0,0,0
1,KABUPATEN/KOTA,62861,TAPIN,0,0,0
2,KECAMATAN,62862,BINUANG,13102,4788,17890
2,KECAMATAN,62991,HATUNGUN,3103,2073,5176
2,KECAMATAN,62981,LOKPAIKAT,2795,2538,5333
2,KECAMATAN,62968,BUNGUR,3562,2748,6310
2,KECAMATAN,62959,PIANI,1512,1693,3205
2,KECAMATAN,62946,BAKARANGAN,2476,1982,4458
2,KECAMATAN,62932,CANDI LARAS UTARA,3611,4377,7988
2,KECAMATAN,62919,CANDI LARAS SELATAN,3196,2799,5995
2,KECAMATAN,62902,TAPIN UTARA,8151,4685,12836
2,KECAMATAN,62884,TAPIN TENGAH,5711,4398,10109
2,KECAMATAN,62873,TAPIN SELATAN,6637,3289,9926
2,KECAMATAN,63000,SALAM BABARIS,4325,2370,6695
1,KABUPATEN/KOTA,63007,HULU SUNGAI SELATAN,58181,37740,95921
2,KECAMATAN,63008,SUNGAI RAYA,0,0,0
2,KECAMATAN,63147,LOKSADO,0,0,0
2,KECAMATAN,63137,KALUMPANG,0,0,0
2,KECAMATAN,63117,DAHA UTARA,0,0,0
2,KECAMATAN,63100,DAHA SELATAN,0,0,0
2,KECAMATAN,63088,SIMPUR,0,0,0
2,KECAMATAN,63069,KANDANGAN,0,0,0
2,KECAMATAN,63057,ANGKINANG,0,0,0
2,KECAMATAN,63045,TELAGA LANGSAT,0,0,0
2,KECAMATAN,63027,PADANG BATUNG,0,0,0
2,KECAMATAN,63159,DAHA BARAT,0,0,0
1,KABUPATEN/KOTA,63167,HULU SUNGAI TENGAH,0,0,0
2,KECAMATAN,63168,HARUYAN,6318,4763,11081
2,KECAMATAN,63326,BATANG ALAI TIMUR,1434,1765,3199
2,KECAMATAN,63313,HANTAKAN,2496,3484,5980
2,KECAMATAN,63298,BATANG ALAI UTARA,5279,4033,9312
2,KECAMATAN,63278,BATANG ALAI SELATAN,8100,4989,13089
2,KECAMATAN,63259,BARABAI,18714,9099,27813
2,KECAMATAN,63237,PANDAWAN,11537,5725,17262
2,KECAMATAN,63220,LABUAN AMAS UTARA,7728,5283,13011
2,KECAMATAN,63201,LABUAN AMAS SELATAN,8580,5780,14360
2,KECAMATAN,63186,BATU BENAWA,6293,4516,10809
2,KECAMATAN,63338,LIMPASU,3305,2570,5875
1,KABUPATEN/KOTA,63348,HULU SUNGAI UTARA,79784,52007,131791
2,KECAMATAN,63349,DANAU PANGGANG,4883,3812,8695
2,KECAMATAN,63552,PAMINGGIR,1837,1549,3386
2,KECAMATAN,63533,HAUR GADING,4157,3434,7591
2,KECAMATAN,63512,BANJANG,4627,3585,8212
2,KECAMATAN,63485,AMUNTAI UTARA,6442,3757,10199
2,KECAMATAN,63455,AMUNTAI TENGAH,14729,9945,24674
2,KECAMATAN,63424,AMUNTAI SELATAN,7944,5079,13023
2,KECAMATAN,63390,SUNGAI PANDAN,7707,5087,12794
2,KECAMATAN,63366,BABIRIK,4556,3736,8292
2,KECAMATAN,63560,SUNGAI TABUKAN,3296,3084,6380
1,KABUPATEN/KOTA,63578,TABALONG,60178,43068,103246
2,KECAMATAN,63579,BANUA LAWAS,5834,3174,9008
2,KECAMATAN,63702,JARO,3190,3559,6749
2,KECAMATAN,63695,UPAU,1544,2309,3853
2,KECAMATAN,63687,PUGAAN,2637,1011,3648
2,KECAMATAN,63679,MUARA HARUS,1756,1352,3108
2,KECAMATAN,63664,MUARA UYA,5430,6476,11906
2,KECAMATAN,63653,MURUNG PUDAK,14184,10608,24792
2,KECAMATAN,63639,HARUAI,7152,4678,11830
2,KECAMATAN,63623,TANJUNG,11263,6945,18208
2,KECAMATAN,63608,TANTA,5384,4440,9824
2,KECAMATAN,63595,KELUA,8062,3468,11530
2,KECAMATAN,63712,BINTANG ARA,2405,2383,4788
1,KABUPATEN/KOTA,63722,TANAH BUMBU,68841,50403,119244
2,KECAMATAN,63723,BATU LICIN,0,0,0
2,KECAMATAN,63841,SIMPANG EMPAT,0,0,0
2,KECAMATAN,63830,KARANG BINTANG,0,0,0
2,KECAMATAN,63823,KURANJI,0,0,0
2,KECAMATAN,63814,ANGSANA,0,0,0
2,KECAMATAN,63793,KUSAN HULU,0,0,0
2,KECAMATAN,63778,SATUI,0,0,0
2,KECAMATAN,63765,SUNGAI LOBAN,0,0,0
2,KECAMATAN,63729,KUSAN HILIR,0,0,0
2,KECAMATAN,63854,MANTEWE,0,0,0
1,KABUPATEN/KOTA,63866,BALANGAN,0,0,0
2,KECAMATAN,63867,JUAI,0,0,0
2,KECAMATAN,63889,HALONG,0,0,0
2,KECAMATAN,63911,AWAYAN,0,0,0
2,KECAMATAN,63935,BATU MANDI,0,0,0
2,KECAMATAN,63954,LAMPIHONG,0,0,0
2,KECAMATAN,63982,PARINGIN,0,0,0
2,KECAMATAN,63999,PARINGIN SELATAN,0,0,0
2,KECAMATAN,64016,TEBING TINGGI,0,0,0
1,KABUPATEN/KOTA,64027,KOTA BANJARMASIN,0,0,0
2,KECAMATAN,64028,BANJARMASIN SELATAN,0,0,0
2,KECAMATAN,64041,BANJARMASIN TIMUR,0,0,0
2,KECAMATAN,64051,BANJARMASIN BARAT,0,0,0
2,KECAMATAN,64061,BANJARMASIN UTARA,0,0,0
2,KECAMATAN,64072,BANJARMASIN TENGAH,0,0,0
1,KABUPATEN/KOTA,64085,KOTA BANJARBARU,0,0,0
2,KECAMATAN,64086,LANDASAN ULIN,0,0,0
2,KECAMATAN,64091,CEMPAKA,0,0,0
2,KECAMATAN,64096,LIANG ANGGANG,0,0,0
2,KECAMATAN,64101,BANJARBARU UTARA,0,0,0
2,KECAMATAN,64106,BANJARBARU SELATAN,0,0,0
0,PROVINSI,64111,KALIMANTAN TIMUR,0,0,0
1,KABUPATEN/KOTA,64112,PASER,0,0,0
2,KECAMATAN,64113,BATU SOPANG,3634,5421,9055
2,KECAMATAN,64228,BATU ENGAU,2344,4277,6621
2,KECAMATAN,64207,LONG KALI,4104,8227,12331
2,KECAMATAN,64194,MUARA KOMAM,2245,3534,5779
2,KECAMATAN,64170,LONG IKIS,8516,11540,20056
2,KECAMATAN,64158,KUARO,6188,7001,13189
2,KECAMATAN,64143,TANAH GROGOT,15253,14730,29983
2,KECAMATAN,64130,PASIR BALENGKONG,5944,6821,12765
2,KECAMATAN,64122,TANJUNG HARAPAN,1082,2123,3205
2,KECAMATAN,64238,MUARA SAMU,1072,1764,2836
1,KABUPATEN/KOTA,64248,KUTAI KARTANEGARA,50382,65438,115820
2,KECAMATAN,64249,MUARA MUNTAI,0,0,0
2,KECAMATAN,64476,MARANG KAYU,0,0,0
2,KECAMATAN,64457,TENGGARONG SEBERANG,0,0,0
2,KECAMATAN,64451,SANGA SANGA,0,0,0
2,KECAMATAN,64442,MUARA JAWA,0,0,0
2,KECAMATAN,64418,SAMBOJA,0,0,0
2,KECAMATAN,64398,TABANG,0,0,0
2,KECAMATAN,64378,MUARA KAMAN,0,0,0
2,KECAMATAN,64366,KEMBANG JANGGUT,0,0,0
2,KECAMATAN,64357,KENOHAN,0,0,0
2,KECAMATAN,64336,KOTA BANGUN,0,0,0
2,KECAMATAN,64322,SEBULU,0,0,0
2,KECAMATAN,64308,TENGGARONG,0,0,0
2,KECAMATAN,64294,MUARA BADAK,0,0,0
2,KECAMATAN,64285,ANGGANA,0,0,0
2,KECAMATAN,64276,LOA JANAN,0,0,0
2,KECAMATAN,64263,LOA KULU,0,0,0
2,KECAMATAN,64488,MUARA WIS,0,0,0
1,KABUPATEN/KOTA,64496,BERAU,0,0,0
2,KECAMATAN,64497,KELAY,0,0,0
2,KECAMATAN,64600,BATU PUTIH,0,0,0
2,KECAMATAN,64595,MARATUA,0,0,0
2,KECAMATAN,64588,TABALAR,0,0,0
2,KECAMATAN,64581,TELUK BAYUR,0,0,0
2,KECAMATAN,64568,PULAU DERAWAN,0,0,0
2,KECAMATAN,64556,GUNUNG TABUR,0,0,0
2,KECAMATAN,64549,TANJUNG REDEB,0,0,0
2,KECAMATAN,64537,SEGAH,0,0,0
2,KECAMATAN,64522,SAMBALIUNG,0,0,0
2,KECAMATAN,64512,TALISAYAN,0,0,0
2,KECAMATAN,64608,BIATAN,0,0,0
1,KABUPATEN/KOTA,64617,BULUNGAN,0,0,0
2,KECAMATAN,64618,TANJUNG PALAS,2952,3393,6345
2,KECAMATAN,64682,SEKATAK,549,3510,4059
2,KECAMATAN,64675,PESO ILIR,399,1219,1618
2,KECAMATAN,64664,PESO,557,1486,2043
2,KECAMATAN,64660,TANJUNG PALAS TENGAH,1199,2318,3517
2,KECAMATAN,64650,TANJUNG SELOR,6831,11518,18349
2,KECAMATAN,64641,TANJUNG PALAS TIMUR,956,3996,4952
2,KECAMATAN,64634,TANJUNG PALAS UTARA,1943,3129,5072
2,KECAMATAN,64628,TANJUNG PALAS BARAT,658,1963,2621
2,KECAMATAN,64705,BUNYU,1840,3878,5718
1,KABUPATEN/KOTA,64709,NUNUKAN,17884,36410,54294
2,KECAMATAN,64710,SEBATIK,0,0,0
2,KECAMATAN,83630,TULIN ONSOI,0,0,0
2,KECAMATAN,83629,SEI MENGGARIS,0,0,0
2,KECAMATAN,83628,SEBATIK TENGAH,0,0,0
2,KECAMATAN,83627,SEBATIK UTARA,0,0,0
2,KECAMATAN,83626,SEBATIK TIMUR,0,0,0
2,KECAMATAN,64944,NUNUKAN SELATAN,0,0,0
2,KECAMATAN,64936,SEBATIK BARAT,0,0,0
2,KECAMATAN,64912,KRAYAN SELATAN,0,0,0
2,KECAMATAN,64890,SEBUKU,0,0,0
2,KECAMATAN,64829,KRAYAN,0,0,0
2,KECAMATAN,64754,LUMBIS,0,0,0
2,KECAMATAN,64733,SEMBAKUNG,0,0,0
2,KECAMATAN,64723,NUNUKAN,0,0,0
2,KECAMATAN,83631,LUMBIS OGONG,0,0,0
1,KABUPATEN/KOTA,64949,MALINAU,0,0,0
2,KECAMATAN,64950,MENTARANG,594,2021,2615
2,KECAMATAN,83639,MALINAU SELATAN HULU,197,883,1080
2,KECAMATAN,83638,MALINAU SELATAN HILIR,224,1093,1317
2,KECAMATAN,65061,MENTARANG HULU,137,322,459
2,KECAMATAN,65054,BAHAU HULU,74,743,817
2,KECAMATAN,65048,KAYAN SELATAN,196,1044,1240
2,KECAMATAN,65042,SUNGAI BOH,183,1140,1323
2,KECAMATAN,65032,MALINAU BARAT,982,3293,4275
2,KECAMATAN,65019,MALINAU UTARA,1233,3676,4909
2,KECAMATAN,64994,MALINAU SELATAN,513,2710,3223
2,KECAMATAN,64988,KAYAN HULU,537,1635,2172
2,KECAMATAN,64982,KAYAN HILIR,291,651,942
2,KECAMATAN,64972,PUJUNGAN,242,624,866
2,KECAMATAN,64965,MALINAU KOTA,2510,6540,9050
2,KECAMATAN,83640,SUNGAI TUBU,53,378,431
1,KABUPATEN/KOTA,65069,KUTAI BARAT,7966,26753,34719
2,KECAMATAN,65070,LONG APARI,1436,867,2303
2,KECAMATAN,65223,PENYINGGAHAN,497,1147,1644
2,KECAMATAN,65229,BENTIAN BESAR,175,1640,1815
2,KECAMATAN,65239,LINGGANG BIGUNG,924,7210,8134
2,KECAMATAN,65249,NYUATAN,417,3303,3720
2,KECAMATAN,65259,SILUQ NGURAI,515,3043,3558
2,KECAMATAN,65275,MOOK MANAAR BULATN,741,3798,4539
2,KECAMATAN,65289,TERING,1183,4016,5199
2,KECAMATAN,65302,SEKOLAQ DARAT,658,5253,5911
2,KECAMATAN,65206,BONGAN,1004,4141,5145
2,KECAMATAN,65193,JEMPANG,1146,4916,6062
2,KECAMATAN,65180,MUARA PAHU,1084,3020,4104
2,KECAMATAN,65081,LONG PAHANGAI,1047,1438,2485
2,KECAMATAN,65093,LONG BAGUN,1507,2183,3690
2,KECAMATAN,65105,LONG HUBUNG,1346,2712,4058
2,KECAMATAN,65114,LONG IRAM,947,2687,3634
2,KECAMATAN,65126,MELAK,2271,4324,6595
2,KECAMATAN,65134,BARONG TONGKOK,2441,11156,13597
2,KECAMATAN,65156,DAMAI,923,4652,5575
2,KECAMATAN,65171,MUARA LAWA,714,3098,3812
2,KECAMATAN,65310,LAHAM,185,1021,1206
1,KABUPATEN/KOTA,65315,KUTAI TIMUR,21161,75625,96786
2,KECAMATAN,65316,MUARA ANCALONG,0,0,0
2,KECAMATAN,65454,BATU AMPAR,0,0,0
2,KECAMATAN,65446,KARANGAN,0,0,0
2,KECAMATAN,65437,KAUBUN,0,0,0
2,KECAMATAN,65428,RANTAU PULUNG,0,0,0
2,KECAMATAN,65421,TELUK PANDAN,0,0,0
2,KECAMATAN,65416,SANGATTA SELATAN,0,0,0
2,KECAMATAN,65408,SANDARAN,0,0,0
2,KECAMATAN,65400,KALIORANG,0,0,0
2,KECAMATAN,65388,BENGALON,0,0,0
2,KECAMATAN,65380,KOMBENG,0,0,0
2,KECAMATAN,65372,TELEN,0,0,0
2,KECAMATAN,65365,BUSANG,0,0,0
2,KECAMATAN,65349,SANGKULIRANG,0,0,0
2,KECAMATAN,65344,SANGATTA UTARA,0,0,0
2,KECAMATAN,65336,MUARA BENGKAL,0,0,0
2,KECAMATAN,65325,MUARA WAHAU,0,0,0
2,KECAMATAN,65461,LONG MESANGAT,0,0,0
1,KABUPATEN/KOTA,65469,PENAJAM PASER UTARA,0,0,0
2,KECAMATAN,65470,PENAJAM,14285,18947,33232
2,KECAMATAN,65494,WARU,3107,5074,8181
2,KECAMATAN,65499,BABULU,6886,8711,15597
2,KECAMATAN,65512,SEPAKU,0,0,0
1,KABUPATEN/KOTA,65675,TANA TIDUNG,24278,32732,57010
2,KECAMATAN,65676,SESAYAP,0,0,0
2,KECAMATAN,65689,SESAYAP HILIR,0,0,0
2,KECAMATAN,65698,TANA LIA,0,0,0
2,KECAMATAN,83646,BETAYAU,0,0,0
1,KABUPATEN/KOTA,65528,KOTA BALIKPAPAN,0,0,0
2,KECAMATAN,65529,BALIKPAPAN TIMUR,13322,19054,32376
2,KECAMATAN,65534,BALIKPAPAN BARAT,19297,25656,44953
2,KECAMATAN,65541,BALIKPAPAN UTARA,27254,39487,66741
2,KECAMATAN,65546,BALIKPAPAN TENGAH,20727,33164,53891
2,KECAMATAN,65554,BALIKPAPAN SELATAN,24352,34000,58352
2,KECAMATAN,83647,BALIKPAPAN KOTA,18121,25741,43862
1,KABUPATEN/KOTA,65567,KOTA SAMARINDA,123073,177102,300175
2,KECAMATAN,65568,PALARAN,10153,16772,26925
2,KECAMATAN,65619,SAMARINDA KOTA,0,0,0
2,KECAMATAN,65613,SUNGAI PINANG,18281,30327,48608
2,KECAMATAN,65607,SAMBUTAN,0,0,0
2,KECAMATAN,65599,SUNGAI KUNJANG,0,0,0
2,KECAMATAN,65593,SAMARINDA UTARA,0,0,0
2,KECAMATAN,65587,SAMARINDA ILIR,0,0,0
2,KECAMATAN,65578,SAMARINDA ULU,29889,35084,64973
2,KECAMATAN,65574,SAMARINDA SEBERANG,11054,15859,26913
2,KECAMATAN,65625,LOA JANAN ILIR,0,0,0
1,KABUPATEN/KOTA,65631,KOTA TARAKAN,69377,98042,167419
2,KECAMATAN,65632,TARAKAN BARAT,0,0,0
2,KECAMATAN,65638,TARAKAN TENGAH,0,0,0
2,KECAMATAN,65644,TARAKAN TIMUR,0,0,0
2,KECAMATAN,65652,TARAKAN UTARA,0,0,0
1,KABUPATEN/KOTA,65656,KOTA BONTANG,0,0,0
2,KECAMATAN,65657,BONTANG UTARA,14615,21761,36376
2,KECAMATAN,65664,BONTANG SELATAN,10537,21736,32273
2,KECAMATAN,65671,BONTANG BARAT,5605,8615,14220
0,PROVINSI,65702,SULAWESI UTARA,0,0,0
1,KABUPATEN/KOTA,65822,BOLAANG MONGONDOW,30757,52112,82869
2,KECAMATAN,65823,SANG TOMBOLANG,3113,2170,5283
2,KECAMATAN,83778,DUMOGA TENGAH,3068,2680,5748
2,KECAMATAN,83401,DUMOGA,3961,3455,7416
2,KECAMATAN,65968,BILALANG,2263,531,2794
2,KECAMATAN,65960,BOLAANG TIMUR,4188,1535,5723
2,KECAMATAN,65952,PASSI TIMUR,3640,2829,6469
2,KECAMATAN,65934,POIGAR,5678,4073,9751
2,KECAMATAN,65923,PASSI BARAT,6907,1547,8454
2,KECAMATAN,65908,LOLAYAN,8916,3691,12607
2,KECAMATAN,65900,BOLAANG,6054,2695,8749
2,KECAMATAN,65878,LOLAK,7309,6815,14124
2,KECAMATAN,65864,DUMOGA UTARA,4491,3112,7603
2,KECAMATAN,65846,DUMOGA TIMUR,5555,5179,10734
2,KECAMATAN,65834,DUMOGA BARAT,5346,2746,8092
2,KECAMATAN,83779,DUMOGA TENGGARA,2872,1356,4228
1,KABUPATEN/KOTA,65974,MINAHASA,73361,44414,117775
2,KECAMATAN,65975,TONDANO BARAT,5290,5546,10836
2,KECAMATAN,66138,TOMBARIRI,5013,5281,10294
2,KECAMATAN,66153,TONDANO UTARA,3608,3168,6776
2,KECAMATAN,66161,LANGOWAN SELATAN,2492,2614,5106
2,KECAMATAN,66171,TONDANO SELATAN,4410,5863,10273
2,KECAMATAN,66180,LANGOWAN UTARA,2214,3310,5524
2,KECAMATAN,83780,KAKAS BARAT,2291,3708,5999
2,KECAMATAN,83781,KAWANGKOAN UTARA,1769,3780,5549
2,KECAMATAN,83782,KAWANGKOAN BARAT,2303,3453,5756
2,KECAMATAN,83783,MANDOLANG,4809,6399,11208
2,KECAMATAN,83784,TOMBARIRI TIMUR,2649,3012,5661
2,KECAMATAN,66129,TOMBULU,3466,6265,9731
2,KECAMATAN,66114,PINELENG,7784,8964,16748
2,KECAMATAN,66100,KAWANGKOAN,2307,4212,6519
2,KECAMATAN,65985,TONDANO TIMUR,3905,4837,8742
2,KECAMATAN,65997,ERIS,2804,3664,6468
2,KECAMATAN,66005,KOMBI,2854,4066,6920
2,KECAMATAN,66017,LEMBEAN TIMUR,2283,2891,5174
2,KECAMATAN,66025,KAKAS,3378,4131,7509
2,KECAMATAN,66046,TOMPASO,1501,3459,4960
2,KECAMATAN,66058,REMBOKEN,2764,4355,7119
2,KECAMATAN,66070,LANGOWAN TIMUR,4131,3882,8013
2,KECAMATAN,66078,LANGOWAN BARAT,4557,5724,10281
2,KECAMATAN,66089,SONDER,4325,7545,11870
2,KECAMATAN,83785,TOMPASO BARAT,2511,3020,5531
1,KABUPATEN/KOTA,66188,KEPULAUAN SANGIHE,85418,113149,198567
2,KECAMATAN,66189,TABUKAN UTARA,0,0,0
2,KECAMATAN,66358,TAHUNA TIMUR,0,0,0
2,KECAMATAN,66351,TAHUNA BARAT,0,0,0
2,KECAMATAN,66344,TABUKAN SELATAN TENGGARA,0,0,0
2,KECAMATAN,66334,TABUKAN SELATAN TENGAH,0,0,0
2,KECAMATAN,66325,TAHUNA,0,0,0
2,KECAMATAN,66316,KENDAHE,0,0,0
2,KECAMATAN,66301,TABUKAN SELATAN,0,0,0
2,KECAMATAN,66282,TABUKAN TENGAH,0,0,0
2,KECAMATAN,66263,MANGANITU,0,0,0
2,KECAMATAN,66242,TAMAKO,0,0,0
2,KECAMATAN,66234,TATOARENG,0,0,0
2,KECAMATAN,66220,MANGANITU SELATAN,0,0,0
2,KECAMATAN,66214,NUSA TABUKAN,0,0,0
2,KECAMATAN,66367,KEPULAUAN MARORE,0,0,0
1,KABUPATEN/KOTA,66371,KEPULAUAN TALAUD,0,0,0
2,KECAMATAN,66372,LIRUNG,1118,2571,3689
2,KECAMATAN,66526,BEO SELATAN,0,0,0
2,KECAMATAN,66519,MORONGE,372,2030,2402
2,KECAMATAN,66512,MELONGUANE TIMUR,0,0,0
2,KECAMATAN,66506,PULUTAN,0,0,0
2,KECAMATAN,66497,BEO UTARA,406,1911,2317
2,KECAMATAN,66495,MIANGAS,0,0,0
2,KECAMATAN,66489,KALONGAN,0,0,0
2,KECAMATAN,66482,SALIBABU,0,0,0
2,KECAMATAN,66461,DAMAU,684,2089,2773
2,KECAMATAN,66445,GEMEH,0,0,0
2,KECAMATAN,66431,MELONGUANE,0,0,0
2,KECAMATAN,66418,KABARUAN,1036,2326,3362
2,KECAMATAN,66408,NANUSA,0,0,0
2,KECAMATAN,66399,ESSANG,677,1274,1951
2,KECAMATAN,66387,RAINIS,912,2564,3476
2,KECAMATAN,66380,BEO,0,0,0
2,KECAMATAN,66534,ESSANG SELATAN,0,0,0
1,KABUPATEN/KOTA,66544,MINAHASA SELATAN,5205,14765,19970
2,KECAMATAN,66545,MODOINDING,2776,4283,7059
2,KECAMATAN,66701,MOTOLING TIMUR,1469,4055,5524
2,KECAMATAN,66692,MOTOLING BARAT,1890,2978,4868
2,KECAMATAN,66680,TATAPAAN,2598,3157,5755
2,KECAMATAN,66671,AMURANG TIMUR,3774,3937,7711
2,KECAMATAN,66661,AMURANG BARAT,3898,5413,9311
2,KECAMATAN,66651,MAESAAN,2394,3572,5966
2,KECAMATAN,66643,KUMELEMBUAI,1645,2712,4357
2,KECAMATAN,66633,TARERAN,3388,4581,7969
2,KECAMATAN,66622,TUMPAAN,4318,5141,9459
2,KECAMATAN,66613,AMURANG,4344,4914,9258
2,KECAMATAN,66596,TENGA,5314,5611,10925
2,KECAMATAN,66585,SINONSAYANG,4754,4450,9204
2,KECAMATAN,66577,MOTOLING,2204,2558,4762
2,KECAMATAN,66565,RANOYAPO,3011,4201,7212
2,KECAMATAN,66554,TOMPASO BARU,3422,3503,6925
2,KECAMATAN,66710,SULUUN TARERAN,2407,2442,4849
1,KABUPATEN/KOTA,66718,MINAHASA UTARA,53606,67508,121114
2,KECAMATAN,66719,KEMA,0,0,0
2,KECAMATAN,66832,TALAWAAN,0,0,0
2,KECAMATAN,66819,KALAWAT,0,0,0
2,KECAMATAN,66803,LIKUPANG TIMUR,0,0,0
2,KECAMATAN,66784,LIKUPANG BARAT,0,0,0
2,KECAMATAN,66772,DIMEMBE,0,0,0
2,KECAMATAN,66752,WORI,0,0,0
2,KECAMATAN,66742,AIRMADIDI,0,0,0
2,KECAMATAN,66729,KAUDITAN,0,0,0
2,KECAMATAN,66845,LIKUPANG SELATAN,0,0,0
1,KABUPATEN/KOTA,66853,MINAHASA TENGGARA,0,0,0
2,KECAMATAN,66854,RATAHAN,0,0,0
2,KECAMATAN,83790,PASAN,0,0,0
2,KECAMATAN,83789,TOMBATU UTARA,0,0,0
2,KECAMATAN,83788,TOMBATU TIMUR,0,0,0
2,KECAMATAN,83787,SILIAN RAYA,0,0,0
2,KECAMATAN,83786,TOULUAAN SELATAN,0,0,0
2,KECAMATAN,66918,TOULUAAN,0,0,0
2,KECAMATAN,66900,TOMBATU,0,0,0
2,KECAMATAN,66890,RATATOTOK,0,0,0
2,KECAMATAN,66879,BELANG,0,0,0
2,KECAMATAN,66870,PUSOMAEN,0,0,0
2,KECAMATAN,83791,RATAHAN TIMUR,0,0,0
1,KABUPATEN/KOTA,66936,BOLAANG MONGONDOW UTARA,0,0,0
2,KECAMATAN,66937,SANGKUB,0,0,0
2,KECAMATAN,66949,BINTAUNA,0,0,0
2,KECAMATAN,66965,BOLANGITANG TIMUR,0,0,0
2,KECAMATAN,66982,BOLANGITANG BARAT,0,0,0
2,KECAMATAN,66999,KAIDIPANG,0,0,0
2,KECAMATAN,67013,PINOGALUMAN,0,0,0
1,KABUPATEN/KOTA,65703,BOLAANG MONGONDOW TIMUR,0,0,0
2,KECAMATAN,65704,TUTUYAN,0,0,0
2,KECAMATAN,65714,KOTABUNAN,0,0,0
2,KECAMATAN,65722,NUANGAN,0,0,0
2,KECAMATAN,65736,MODAYAG,0,0,0
2,KECAMATAN,65754,MODAYAG BARAT,0,0,0
1,KABUPATEN/KOTA,65760,BOLAANG MONGONDOW SELATAN,0,0,0
2,KECAMATAN,65761,BOLAANG UKI,7350,4511,11861
2,KECAMATAN,65780,POSIGADAN,5509,4442,9951
2,KECAMATAN,65796,PINOLOSIAN,2984,2449,5433
2,KECAMATAN,65806,PINOLOSIAN TENGAH,1977,983,2960
2,KECAMATAN,65812,PINOLOSIAN TIMUR,1804,2110,3914
1,KABUPATEN/KOTA,67130,KOTA MANADO,19624,14495,34119
2,KECAMATAN,67131,BUNAKEN,0,0,0
2,KECAMATAN,83792,BUNAKEN KEPULAUAN,0,0,0
2,KECAMATAN,67217,MALALAYANG,0,0,0
2,KECAMATAN,67205,MAPANGET,0,0,0
2,KECAMATAN,67195,WANEA,13200,17937,31137
2,KECAMATAN,67187,SARIO,0,0,0
2,KECAMATAN,67174,TIKALA,0,0,0
2,KECAMATAN,67161,WENANG,8481,10733,19214
2,KECAMATAN,67151,SINGKIL,10854,14405,25259
2,KECAMATAN,67140,TUMINITING,0,0,0
2,KECAMATAN,83793,PAAL DUA,0,0,0
1,KABUPATEN/KOTA,67227,KOTA BITUNG,32535,43075,75610
2,KECAMATAN,67228,LEMBEH SELATAN,1874,3465,5339
2,KECAMATAN,67236,MADIDIR,6453,10788,17241
2,KECAMATAN,67245,RANOWULU,3990,5826,9816
2,KECAMATAN,67257,AERTEMBAGA,5372,9769,15141
2,KECAMATAN,67268,MATUARI,6693,8791,15484
2,KECAMATAN,67277,GIRIAN,7739,7894,15633
2,KECAMATAN,67285,MAESA,7912,10676,18588
2,KECAMATAN,67294,LEMBEH UTARA,1601,3613,5214
1,KABUPATEN/KOTA,67305,KOTA TOMOHON,41634,60822,102456
2,KECAMATAN,67306,TOMOHON SELATAN,6415,7323,13738
2,KECAMATAN,67319,TOMOHON TENGAH,5233,6321,11554
2,KECAMATAN,67329,TOMOHON UTARA,7144,9131,16275
2,KECAMATAN,67340,TOMOHON BARAT,4416,5000,9416
2,KECAMATAN,67349,TOMOHON TIMUR,2929,3626,6555
1,KABUPATEN/KOTA,67355,KOTA KOTAMOBAGU,26137,31401,57538
2,KECAMATAN,67356,KOTAMOBAGU UTARA,0,0,0
2,KECAMATAN,67365,KOTAMOBAGU TIMUR,0,0,0
2,KECAMATAN,67376,KOTAMOBAGU SELATAN,11344,3986,15330
2,KECAMATAN,67386,KOTAMOBAGU BARAT,0,0,0
0,PROVINSI,67393,SULAWESI TENGAH,0,0,0
1,KABUPATEN/KOTA,67558,BANGGAI,11344,3986,15330
2,KECAMATAN,67559,BATUI,3211,5383,8594
2,KECAMATAN,67803,MOILONG,4040,5870,9910
2,KECAMATAN,67820,BATUI SELATAN,2206,5029,7235
2,KECAMATAN,67831,LOBU,0,0,0
2,KECAMATAN,67841,SIMPANG RAYA,2113,5189,7302
2,KECAMATAN,67854,BALANTAK SELATAN,0,0,0
2,KECAMATAN,83794,BALANTAK UTARA,977,1198,2175
2,KECAMATAN,83795,LUWUK SELATAN,6049,4642,10691
2,KECAMATAN,83796,LUWUK UTARA,4198,4145,8343
2,KECAMATAN,83797,MANTOH,1062,2456,3518
2,KECAMATAN,67784,NUHON,0,0,0
2,KECAMATAN,67767,TOILI BARAT,3782,8036,11818
2,KECAMATAN,67754,LUWUK TIMUR,2897,3074,5971
2,KECAMATAN,67573,BUNTA,3780,5760,9540
2,KECAMATAN,67593,KINTOM,2851,2988,5839
2,KECAMATAN,67608,LUWUK,8336,8283,16619
2,KECAMATAN,67630,LAMALA,1348,2169,3517
2,KECAMATAN,67650,BALANTAK,994,1976,2970
2,KECAMATAN,67669,PAGIMANA,6135,6068,12203
2,KECAMATAN,67702,BUALEMO,5639,3797,9436
2,KECAMATAN,67719,TOILI,6297,11298,17595
2,KECAMATAN,67742,MASAMA,2108,4426,6534
2,KECAMATAN,83798,NAMBO,2615,2102,4717
1,KABUPATEN/KOTA,67866,POSO,70638,93889,164527
2,KECAMATAN,67867,POSO KOTA,5639,4119,9758
2,KECAMATAN,68031,PAMONA TENGGARA,1739,2196,3935
2,KECAMATAN,68025,LORE PIORE,1005,991,1996
2,KECAMATAN,68020,LORE TIMUR,1027,1880,2907
2,KECAMATAN,68013,LORE BARAT,861,914,1775
2,KECAMATAN,68006,POSO KOTA UTARA,3460,2365,5825
2,KECAMATAN,68000,POSO KOTA SELATAN,2442,2337,4779
2,KECAMATAN,67994,PAMONA BARAT,1656,3432,5088
2,KECAMATAN,67985,POSO PESISIR SELATAN,2954,2473,5427
2,KECAMATAN,67975,POSO PESISIR UTARA,3212,4812,8024
2,KECAMATAN,67966,LORE SELATAN,1903,1630,3533
2,KECAMATAN,67957,LORE TENGAH,1442,1001,2443
2,KECAMATAN,67949,LORE UTARA,2918,3114,6032
2,KECAMATAN,67936,PAMONA SELATAN,4603,5603,10206
2,KECAMATAN,67923,PAMONA TIMUR,2504,3762,6266
2,KECAMATAN,67902,PAMONA UTARA,2309,5575,7884
2,KECAMATAN,67887,LAGE,4840,5829,10669
2,KECAMATAN,67872,POSO PESISIR,4934,4908,9842
2,KECAMATAN,83799,PAMONA PUSELEMBA,3703,7022,10725
1,KABUPATEN/KOTA,68041,DONGGALA,53151,63963,117114
2,KECAMATAN,68042,RIO PAKAVA,3096,6738,9834
2,KECAMATAN,68192,SOJOL UTARA,892,3644,4536
2,KECAMATAN,68184,BANAWA TENGAH,3514,1943,5457
2,KECAMATAN,68178,SINDUE TOBATA,1468,2834,4302
2,KECAMATAN,68172,SINDUE TOMBUSABORA,2319,2904,5223
2,KECAMATAN,68165,PANEMBANI,1966,1644,3610
2,KECAMATAN,68156,TANANTOVEA,4413,4116,8529
2,KECAMATAN,68140,BANAWA SELATAN,4895,6430,11325
2,KECAMATAN,68130,SOJOL,2447,8855,11302
2,KECAMATAN,68119,BALAESANG,4402,6222,10624
2,KECAMATAN,68106,SIRENJA,3594,6270,9864
2,KECAMATAN,68092,SINDUE,6339,3985,10324
2,KECAMATAN,68085,LABUAN,3625,3340,6965
2,KECAMATAN,68070,BANAWA,8770,7968,16738
2,KECAMATAN,68057,DOMPELAS SOJOL,5332,9500,14832
2,KECAMATAN,68197,BALAESANG TANJUNG,2057,3228,5285
1,KABUPATEN/KOTA,68206,TOLITOLI,59129,79621,138750
2,KECAMATAN,68207,DAMPAL SELATAN,1504,9285,10789
2,KECAMATAN,68282,GALANG,5591,10835,16426
2,KECAMATAN,68268,BAOLAN,0,0,0
2,KECAMATAN,68259,LAMPASIO,1585,4508,6093
2,KECAMATAN,68247,OGODEIDE,1859,4234,6093
2,KECAMATAN,68239,BASIDONDO,1293,3714,5007
2,KECAMATAN,68226,DONDO,3103,7446,10549
2,KECAMATAN,68217,DAMPAL UTARA,2217,3988,6205
2,KECAMATAN,68304,DAKO PEMEAN,1933,2672,4605
1,KABUPATEN/KOTA,68309,BUOL,19085,46682,65767
2,KECAMATAN,68310,MOMUNU,0,0,0
2,KECAMATAN,68414,BIAU,6794,6129,12923
2,KECAMATAN,68406,PALELEH BARAT,1414,1613,3027
2,KECAMATAN,68398,KARAMAT,2088,2366,4454
2,KECAMATAN,68387,GADUNG,2652,2612,5264
2,KECAMATAN,68374,BUKAL,0,0,0
2,KECAMATAN,68364,TILOAN,2198,2887,5085
2,KECAMATAN,68351,PALELEH,0,0,0
2,KECAMATAN,68342,BUNOBOGU,2210,2292,4502
2,KECAMATAN,68326,BOKAT,0,0,0
2,KECAMATAN,68422,LAKEA,1987,2815,4802
1,KABUPATEN/KOTA,68428,MOROWALI,19343,20714,40057
2,KECAMATAN,68429,MORIS ATAS,0,0,0
2,KECAMATAN,83805,BUNGKU TIMUR,0,0,0
2,KECAMATAN,83804,PETASIA TIMUR,0,0,0
2,KECAMATAN,83803,LEMBO RAYA,0,0,0
2,KECAMATAN,83802,BUNGKU PESISIR,0,0,0
2,KECAMATAN,83801,MORI UTARA,0,0,0
2,KECAMATAN,68666,MAMOSALATO,0,0,0
2,KECAMATAN,68656,WITA PONDA,0,0,0
2,KECAMATAN,68646,SOYO JAYA,0,0,0
2,KECAMATAN,68633,BAHODOPI,0,0,0
2,KECAMATAN,68619,BUMI RAYA,0,0,0
2,KECAMATAN,68608,BUNGKU BARAT,0,0,0
2,KECAMATAN,68589,MENUI KEPULAUAN,0,0,0
2,KECAMATAN,68555,BUNGKU SELATAN,0,0,0
2,KECAMATAN,68525,BUNGKU TENGAH,0,0,0
2,KECAMATAN,68504,BUNGKU UTARA,0,0,0
2,KECAMATAN,68475,PETASIA,0,0,0
2,KECAMATAN,68450,LEMBO,0,0,0
2,KECAMATAN,83806,PETASIA BARAT,0,0,0
1,KABUPATEN/KOTA,68681,BANGGAI KEPULAUAN,0,0,0
2,KECAMATAN,68682,LABOBO,0,0,0
2,KECAMATAN,68872,BUKO SELATAN,0,0,0
2,KECAMATAN,68860,BULAGI UTARA,0,0,0
2,KECAMATAN,68848,PELING TENGAH,0,0,0
2,KECAMATAN,68840,TOTIKUM SELATAN,0,0,0
2,KECAMATAN,68834,BANGGAI SELATAN,0,0,0
2,KECAMATAN,68827,BANGGAI TENGAH,0,0,0
2,KECAMATAN,68816,BANGKURUNG,0,0,0
2,KECAMATAN,68806,TINANGKUNG SELATAN,0,0,0
2,KECAMATAN,68799,BANGGAI UTARA,0,0,0
2,KECAMATAN,68784,BULAGI SELATAN,0,0,0
2,KECAMATAN,68768,BOKAN KEPULAUAN,0,0,0
2,KECAMATAN,68757,BUKO,0,0,0
2,KECAMATAN,68741,BULAGI,0,0,0
2,KECAMATAN,68725,LIANG,0,0,0
2,KECAMATAN,68713,TINANGKUNG,0,0,0
2,KECAMATAN,68701,TOTIKUM,0,0,0
2,KECAMATAN,68690,BANGGAI,0,0,0
2,KECAMATAN,68881,TINANGKUNG UTARA,0,0,0
1,KABUPATEN/KOTA,68887,PARIGI MOUTONG,0,0,0
2,KECAMATAN,68888,PARIGI,5326,8578,13904
2,KECAMATAN,69031,TORIBULU,2986,5023,8009
2,KECAMATAN,69039,TAOPA,3065,3621,6686
2,KECAMATAN,69047,BALINGGI,4046,5640,9686
2,KECAMATAN,69054,PARIGI BARAT,1979,1950,3929
2,KECAMATAN,69060,SINIU,2721,2241,4962
2,KECAMATAN,69067,PALASA,4965,6917,11882
2,KECAMATAN,69076,PARIGI UTARA,2071,1137,3208
2,KECAMATAN,69082,PARIGI TENGAH,2295,2003,4298
2,KECAMATAN,89758,BOLANO,4159,4182,8341
2,KECAMATAN,69020,MEPANGA,6782,7486,14268
2,KECAMATAN,69011,PARIGI SELATAN,3900,7377,11277
2,KECAMATAN,68899,AMPIBABO,5360,5245,10605
2,KECAMATAN,68911,TINOMBO,7819,8262,16081
2,KECAMATAN,68926,MOUTONG,4963,5606,10569
2,KECAMATAN,68938,TOMINI,4855,3806,8661
2,KECAMATAN,68948,SAUSU,4229,6868,11097
2,KECAMATAN,68957,BOLANO LAMBUNU,4409,6417,10826
2,KECAMATAN,68980,KASIMBAR,4154,6826,10980
2,KECAMATAN,68989,TORUE,3278,6913,10191
2,KECAMATAN,68996,TINOMBO SELATAN,5464,6925,12389
2,KECAMATAN,89765,ONGKA MALINO,4692,5307,9999
1,KABUPATEN/KOTA,67394,SIGI,93518,118330,211848
2,KECAMATAN,67395,SIGI BIROMARU,15899,8366,24265
2,KECAMATAN,67536,MARAWOLA,8318,3991,12309
2,KECAMATAN,67527,KINOVARO,4045,2029,6074
2,KECAMATAN,67515,DOLO,8345,3524,11869
2,KECAMATAN,67504,DOLO BARAT,5141,2050,7191
2,KECAMATAN,67499,TANAMBULAVA,2875,1710,4585
2,KECAMATAN,67487,DOLO SELATAN,5592,1939,7531
2,KECAMATAN,67480,GUMBASA,3969,2836,6805
2,KECAMATAN,67468,PIPIKORO,2480,2625,5105
2,KECAMATAN,67457,KULAWI SELATAN,1922,2758,4680
2,KECAMATAN,67444,KULAWI,4279,3984,8263
2,KECAMATAN,67439,LINDU,1171,1620,2791
2,KECAMATAN,67433,NOKILALAKI,1285,1535,2820
2,KECAMATAN,67413,PALOLO,6774,8908,15682
2,KECAMATAN,67547,MARAWOLA BARAT,1710,2688,4398
1,KABUPATEN/KOTA,69220,KOTA PALU,73805,50563,124368
2,KECAMATAN,69221,PALU TIMUR,12434,11883,24317
2,KECAMATAN,69230,PALU BARAT,11274,13643,24917
2,KECAMATAN,69246,PALU SELATAN,16249,16945,33194
2,KECAMATAN,69259,PALU UTARA,5622,5009,10631
2,KECAMATAN,83807,ULUJADI,9504,5899,15403
2,KECAMATAN,83808,TATANGA,12550,9089,21639
2,KECAMATAN,83809,TAWAELI,5714,5013,10727
2,KECAMATAN,83810,MANTIKULORE,17397,14280,31677
0,PROVINSI,69268,SULAWESI SELATAN,0,0,0
1,KABUPATEN/KOTA,69442,KEPULAUAN SELAYAR,90744,81761,172505
2,KECAMATAN,69443,BENTENG,0,0,0
2,KECAMATAN,69519,PASIMASUNGGU TIMUR,0,0,0
2,KECAMATAN,69513,PASILAMBENA,0,0,0
2,KECAMATAN,69504,TAKA BONERATE,0,0,0
2,KECAMATAN,69497,PASIMARANNU,0,0,0
2,KECAMATAN,69490,PASIMASUNGGU,0,0,0
2,KECAMATAN,69478,BONTOSIKUYU,0,0,0
2,KECAMATAN,69469,BONTOMANAI,0,0,0
2,KECAMATAN,69456,BONTOMATENE,0,0,0
2,KECAMATAN,69447,BONTOHARU,0,0,0
2,KECAMATAN,69524,BUKI,0,0,0
1,KABUPATEN/KOTA,69531,BULUKUMBA,0,0,0
2,KECAMATAN,69532,GANTARANG,11986,24716,36702
2,KECAMATAN,69641,UJUNGLOE,5202,14366,19568
2,KECAMATAN,69631,KINDANG,4160,10722,14882
2,KECAMATAN,69614,BULUKUMPA,6264,20696,26960
2,KECAMATAN,69594,KAJANG,5785,16607,22392
2,KECAMATAN,69585,HERLANG,2889,9719,12608
2,KECAMATAN,69572,BONTO TIRO,2837,9824,12661
2,KECAMATAN,69563,BONTO BAHARI,2094,9419,11513
2,KECAMATAN,69553,UJUNG BULU,7224,15716,22940
2,KECAMATAN,69654,RILAUALE,4529,15787,20316
1,KABUPATEN/KOTA,69668,BANTAENG,52970,147572,200542
2,KECAMATAN,69669,BISSAPPU,6908,9192,16100
2,KECAMATAN,69681,BANTAENG,8860,9834,18694
2,KECAMATAN,69691,EREMERASA,3516,4623,8139
2,KECAMATAN,69701,TOMPO BULU,3287,7684,10971
2,KECAMATAN,69712,PAJUKUKANG,6618,6401,13019
2,KECAMATAN,69723,ULUERE,1946,3413,5359
2,KECAMATAN,69730,GANTARANG KEKE,2392,5280,7672
2,KECAMATAN,69737,SINOA,2876,3228,6104
1,KABUPATEN/KOTA,69744,JENEPONTO,36403,49655,86058
2,KECAMATAN,69745,BANGKALA,10648,16105,26753
2,KECAMATAN,69847,RUMBIA,4503,8295,12798
2,KECAMATAN,69839,ARUNGKEKE,6794,2857,9651
2,KECAMATAN,69827,TURATEA,7698,6708,14406
2,KECAMATAN,69814,BONTORAMBA,8075,8828,16903
2,KECAMATAN,69805,BANGKALA BARAT,4761,7620,12381
2,KECAMATAN,69794,KELARA,7132,4960,12092
2,KECAMATAN,69787,BATANG,6721,2840,9561
2,KECAMATAN,69773,BINAMU,14087,11962,26049
2,KECAMATAN,69760,TAMALATEA,9203,9797,19000
2,KECAMATAN,69860,TAROWANG,6200,5059,11259
1,KABUPATEN/KOTA,69869,TAKALAR,85822,85031,170853
2,KECAMATAN,69870,MAPPAKASUNGGU,1840,6141,7981
2,KECAMATAN,69877,MANGARABOMBANG,6477,12530,19007
2,KECAMATAN,69890,POLOMBANGKENG SELATAN,5404,10273,15677
2,KECAMATAN,69899,POLOMBANGKENG UTARA,11400,15637,27037
2,KECAMATAN,69915,GALESONG SELATAN,4320,9026,13346
2,KECAMATAN,69925,GALESONG UTARA,6253,14474,20727
2,KECAMATAN,69934,PATTALLASSANG,7362,11921,19283
2,KECAMATAN,69943,SANROBONE,2328,4896,7224
2,KECAMATAN,69949,GALESONG,5914,13578,19492
1,KABUPATEN/KOTA,69962,GOWA,51298,98476,149774
2,KECAMATAN,69963,BONTONOMPO,11232,13790,25022
2,KECAMATAN,70135,PARIGI,2045,5618,7663
2,KECAMATAN,70125,BONTONOMPO SELATAN,6763,10815,17578
2,KECAMATAN,70116,BONTOLEMPANGANG,2717,5819,8536
2,KECAMATAN,70108,MANUJU,3165,5147,8312
2,KECAMATAN,70099,PATTALASANG,3730,9667,13397
2,KECAMATAN,70091,BAROMBONG,6855,13887,20742
2,KECAMATAN,70079,BIRINGBULU,7248,12643,19891
2,KECAMATAN,70069,TOMBOLOPAO,4535,9677,14212
2,KECAMATAN,70060,BUNGAYA,2469,6283,8752
2,KECAMATAN,70045,SOMBA UPU,23272,42938,66210
2,KECAMATAN,70028,PALANGGA,19477,35741,55218
2,KECAMATAN,70018,BONTOMARANNU,6480,10945,17425
2,KECAMATAN,70010,PARANGLOE,2983,6524,9507
2,KECAMATAN,70002,TINGGIMONCONG,3829,9074,12903
2,KECAMATAN,69993,TOMPOBULLU,5216,11485,16701
2,KECAMATAN,69978,BAJENG,14734,21661,36395
2,KECAMATAN,70141,BAJENG BARAT,4873,9911,14784
1,KABUPATEN/KOTA,70149,SINJAI,131623,241625,373248
2,KECAMATAN,70150,SINJAI BARAT,4560,6997,11557
2,KECAMATAN,70160,SINJAI  SELATAN,6443,12670,19113
2,KECAMATAN,70172,SINJAI TIMUR,4904,9715,14619
2,KECAMATAN,70186,SINJAI TENGAH,4967,8662,13629
2,KECAMATAN,70198,SINJAI UTARA,8055,13050,21105
2,KECAMATAN,70205,BULUPODDO,3230,5534,8764
2,KECAMATAN,70213,SINJAI BORONG,3019,4694,7713
2,KECAMATAN,70222,TELLU LIMPOE,5916,10632,16548
2,KECAMATAN,70234,PULAU SEMBILAN,948,2321,3269
1,KABUPATEN/KOTA,70239,BONE,42042,74275,116317
2,KECAMATAN,70240,BONTOCANI,1630,6827,8457
2,KECAMATAN,70471,AWANGPONE,1104,15895,16999
2,KECAMATAN,70490,TELLU SIATTINGE,2065,19366,21431
2,KECAMATAN,70508,AJANGALE,1722,13045,14767
2,KECAMATAN,70523,DUA BOCCOE,2011,14928,16939
2,KECAMATAN,70546,CENRANA,939,12692,13631
2,KECAMATAN,70563,TANETE RIATTANG,0,0,0
2,KECAMATAN,70572,TANETE RIATTANG BARAT,0,0,0
2,KECAMATAN,70581,TANETE RIATTANG TIMUR,0,0,0
2,KECAMATAN,70590,AMALI,0,0,0
2,KECAMATAN,70606,TELLULIMPOE,0,0,0
2,KECAMATAN,70618,BENGO,0,0,0
2,KECAMATAN,70455,PALAKKA,1891,10641,12532
2,KECAMATAN,70439,ULAWENG,2733,11948,14681
2,KECAMATAN,70426,LAMURU,1112,11772,12884
2,KECAMATAN,70252,KAHU,0,0,0
2,KECAMATAN,70273,KAJUARA,4609,12523,17132
2,KECAMATAN,70292,SALOMEKKO,1598,5623,7221
2,KECAMATAN,70301,TONRA,1034,5924,6958
2,KECAMATAN,70313,LIBURENG,2307,14427,16734
2,KECAMATAN,70334,MARE,2586,10283,12869
2,KECAMATAN,70353,SIBULUE,1776,15784,17560
2,KECAMATAN,70374,BAREBBO,0,0,0
2,KECAMATAN,70393,CINA,1861,12503,14364
2,KECAMATAN,70406,PONRE,803,6627,7430
2,KECAMATAN,70416,LAPPARIAJA,557,6079,6636
2,KECAMATAN,70628,PATIMPENG,0,0,0
1,KABUPATEN/KOTA,70639,MAROS,32338,206887,239225
2,KECAMATAN,70640,MANDAI,6516,12687,19203
2,KECAMATAN,70743,MONCONG LOE,2903,6345,9248
2,KECAMATAN,70736,LAU,3391,10260,13651
2,KECAMATAN,70727,TOMPOBULU,1699,4984,6683
2,KECAMATAN,70719,CENRANA,1464,5984,7448
2,KECAMATAN,70712,SIMBANG,4057,7646,11703
2,KECAMATAN,70704,MARUSU,4421,10634,15055
2,KECAMATAN,70695,TANRALILI,5100,6885,11985
2,KECAMATAN,70683,MALLLAWA,1724,4939,6663
2,KECAMATAN,70673,BONTOA,2691,12089,14780
2,KECAMATAN,70665,MAROS BARU,2764,9847,12611
2,KECAMATAN,70656,BANTIMURUNG,3748,12132,15880
2,KECAMATAN,70647,CAMBA,1240,6293,7533
2,KECAMATAN,70749,TURIKALE,5473,15994,21467
1,KABUPATEN/KOTA,70757,PANGKAJENE DAN KEPULAUAN,47191,126719,173910
2,KECAMATAN,70758,LIUKANG TANGAYA,2770,6494,9264
2,KECAMATAN,70858,TONDONG TALLASA,1103,4119,5222
2,KECAMATAN,70851,MANDALLE,1811,4726,6537
2,KECAMATAN,70842,MINASA TENE,5843,12337,18180
2,KECAMATAN,70835,SEGERI,1824,8432,10256
2,KECAMATAN,70824,MARANG,5292,10618,15910
2,KECAMATAN,70810,LABAKKANG,7813,14953,22766
2,KECAMATAN,70801,BUNGORO,7841,13878,21719
2,KECAMATAN,70795,BALOCCI,2532,5889,8421
2,KECAMATAN,70785,PANGKAJENE,6350,16761,23111
2,KECAMATAN,70776,LIUKANG TUPABBIRING,1435,7786,9221
2,KECAMATAN,70768,LIUKANG KALMAS,1804,4528,6332
2,KECAMATAN,70865,LIUKANG TUPABBIRING UTARA,1050,5677,6727
1,KABUPATEN/KOTA,70873,BARRU,47468,116198,163666
2,KECAMATAN,70874,TANETE RIAJA,0,0,0
2,KECAMATAN,70882,TANETE RILAU,0,0,0
2,KECAMATAN,70893,BARRU,0,0,0
2,KECAMATAN,70904,SOPPENG RIAJA,0,0,0
2,KECAMATAN,70912,MALLUSETASI,0,0,0
2,KECAMATAN,70921,PUJANANTING,0,0,0
2,KECAMATAN,70928,BALUSU,0,0,0
1,KABUPATEN/KOTA,70935,SOPPENG,0,0,0
2,KECAMATAN,70936,MARIORIWAWO,0,0,0
2,KECAMATAN,70950,LILIRIAJA,0,0,0
2,KECAMATAN,70959,LILIRILAU,0,0,0
2,KECAMATAN,70972,LALABATA,0,0,0
2,KECAMATAN,70983,MARIORIAWA,0,0,0
2,KECAMATAN,70994,DONRI DONRI,0,0,0
2,KECAMATAN,71004,GANRA,0,0,0
2,KECAMATAN,71009,CITTA,0,0,0
1,KABUPATEN/KOTA,71014,WAJO,0,0,0
2,KECAMATAN,71015,SABANGPARU,0,0,0
2,KECAMATAN,71187,GILIRENG,0,0,0
2,KECAMATAN,71175,PENRANG,0,0,0
2,KECAMATAN,71162,BOLA,0,0,0
2,KECAMATAN,71147,PITUMPANUA,0,0,0
2,KECAMATAN,71138,MANIANGPAJO,0,0,0
2,KECAMATAN,71118,TANASITOLO,0,0,0
2,KECAMATAN,71107,BELAWA,0,0,0
2,KECAMATAN,71090,TEMPE,0,0,0
2,KECAMATAN,71071,MAJAULENG,0,0,0
2,KECAMATAN,71061,SAJOANGING,0,0,0
2,KECAMATAN,71047,TAKKALALLA,0,0,0
2,KECAMATAN,71031,PAMMANA,0,0,0
2,KECAMATAN,71198,KEERA,0,0,0
1,KABUPATEN/KOTA,71209,SIDENRENG RAPPANG,0,0,0
2,KECAMATAN,71210,PANCA LAUTANG,1099,8889,9988
2,KECAMATAN,71301,PITU RIAWA,2923,11684,14607
2,KECAMATAN,71290,DUA PITUE,2774,12804,15578
2,KECAMATAN,71268,MARITENGNGAE,4629,21492,26121
2,KECAMATAN,71261,KULO,1409,5153,6562
2,KECAMATAN,71252,PANCA RIJANG,3708,12151,15859
2,KECAMATAN,71242,BARANTI,3131,13517,16648
2,KECAMATAN,71231,WATANG PULU,4310,12557,16867
2,KECAMATAN,71221,TELLU LIMPOE,3115,10380,13495
2,KECAMATAN,71314,PITU RIASE,2212,9239,11451
1,KABUPATEN/KOTA,71327,PINRANG,29310,117866,147176
2,KECAMATAN,71328,MATIRRO SOMPE,2730,11963,14693
2,KECAMATAN,71431,BATU LAPPA,1334,3920,5254
2,KECAMATAN,71423,LANRISANG,0,0,0
2,KECAMATAN,71417,TIROANG,0,0,0
2,KECAMATAN,71409,CEMPA,1855,7360,9215
2,KECAMATAN,71394,LEMBANG,0,0,0
2,KECAMATAN,71379,DUAMPANUA,4658,17165,21823
2,KECAMATAN,71368,PATAMPANUA,4613,11696,16309
2,KECAMATAN,71359,WATANG SAWITO,6848,19833,26681
2,KECAMATAN,71349,MATTIRO BULU,2989,12846,15835
2,KECAMATAN,71338,SUPPA,0,0,0
2,KECAMATAN,83765,PALETEANG,0,0,0
1,KABUPATEN/KOTA,71437,ENREKANG,25027,84783,109810
2,KECAMATAN,71438,MAIWA,3733,8964,12697
2,KECAMATAN,71566,MASALLE,1701,4537,6238
2,KECAMATAN,71557,BUNTU BATU,2592,4570,7162
2,KECAMATAN,71548,MALUA,2055,2152,4207
2,KECAMATAN,71536,CURIO,3004,4628,7632
2,KECAMATAN,71528,CENDANA,1891,2737,4628
2,KECAMATAN,71521,BUNGIN,1076,1491,2567
2,KECAMATAN,71512,ALLA,4622,5945,10567
2,KECAMATAN,71496,ANGGERAJA,5083,8077,13160
2,KECAMATAN,71480,BARAKA,5530,5745,11275
2,KECAMATAN,71461,ENREKANG,6609,10063,16672
2,KECAMATAN,71573,BAROKO,1914,3501,5415
1,KABUPATEN/KOTA,71579,LUWU,39810,62410,102220
2,KECAMATAN,71580,BASSE SANGTEMPE,705,3221,3926
2,KECAMATAN,71739,KAMANRE,1429,4346,5775
2,KECAMATAN,71748,BELOPA UTARA,2341,5254,7595
2,KECAMATAN,71757,WALENRANG BARAT,2824,4132,6956
2,KECAMATAN,71764,WALENRANG UTARA,4331,7626,11957
2,KECAMATAN,71776,WALENRANG TIMUR,3142,5348,8490
2,KECAMATAN,71785,LAMASI TIMUR,1935,4226,6161
2,KECAMATAN,71795,SULI BARAT,830,4166,4996
2,KECAMATAN,71804,BAJO BARAT,1463,3510,4973
2,KECAMATAN,71814,PONRANG SELATAN,3871,10335,14206
2,KECAMATAN,71726,LATIMOJONG,957,2190,3147
2,KECAMATAN,71715,PONRANG,4558,9108,13666
2,KECAMATAN,71605,LAROMPONG,2863,8972,11835
2,KECAMATAN,71619,SULI,2795,7453,10248
2,KECAMATAN,71633,BAJO,3901,5518,9419
2,KECAMATAN,71646,BUA PONRANG,2733,5233,7966
2,KECAMATAN,71657,WALENRANG,4940,8375,13315
2,KECAMATAN,71667,BELOPA,3004,5845,8849
2,KECAMATAN,71677,BUA,4287,10712,14999
2,KECAMATAN,71693,LAMASI,5601,5629,11230
2,KECAMATAN,71704,LAROMPONG SELATAN,1766,7184,8950
2,KECAMATAN,83763,BASSE SANGTEMPE UTARA,807,3394,4201
1,KABUPATEN/KOTA,71828,TANA TORAJA,61083,131777,192860
2,KECAMATAN,71829,SALUPUTI,0,0,0
2,KECAMATAN,71994,RANO,0,0,0
2,KECAMATAN,71987,MALIMBONG BALEPE,0,0,0
2,KECAMATAN,71980,SANGALLA UTARA,0,0,0
2,KECAMATAN,71974,SANGALLA SELATAN,0,0,0
2,KECAMATAN,71965,MASANDA,0,0,0
2,KECAMATAN,71956,MAKALE SELATAN,0,0,0
2,KECAMATAN,71949,MAPPAK,0,0,0
2,KECAMATAN,71943,MAKALE UTARA,0,0,0
2,KECAMATAN,71929,REMBON,0,0,0
2,KECAMATAN,71916,GANDANGBATU SILLANAN,0,0,0
2,KECAMATAN,71910,SANGALLA,0,0,0
2,KECAMATAN,71892,MENGKENDEK,0,0,0
2,KECAMATAN,71885,RANTETAYO,0,0,0
2,KECAMATAN,71878,SIMBUANG,0,0,0
2,KECAMATAN,71862,MAKALE,0,0,0
2,KECAMATAN,71855,BONGGAKARADENG,0,0,0
2,KECAMATAN,71839,BITTUANG,0,0,0
2,KECAMATAN,72000,KURRA,0,0,0
1,KABUPATEN/KOTA,72007,LUWU UTARA,0,0,0
2,KECAMATAN,72008,MALANGKE,2062,11021,13083
2,KECAMATAN,72169,BAEBUNTA,7515,15564,23079
2,KECAMATAN,72153,MAPPEDECENG,3669,8870,12539
2,KECAMATAN,72146,RAMPI,468,1018,1486
2,KECAMATAN,72132,MALANGKE BARAT,2418,9047,11465
2,KECAMATAN,72119,SEKO,3845,3126,6971
2,KECAMATAN,72093,SUKAMAJU,10048,12952,23000
2,KECAMATAN,72085,LIMBONG,837,771,1608
2,KECAMATAN,72064,SABBANG,6339,12082,18421
2,KECAMATAN,72044,MASAMBA,4654,11692,16346
2,KECAMATAN,72023,BONE BONE,4915,8083,12998
2,KECAMATAN,83764,TANA LILI,4268,7237,11505
1,KABUPATEN/KOTA,72190,LUWU TIMUR,51038,101463,152501
2,KECAMATAN,72191,MANGKUTANA,3958,7090,11048
2,KECAMATAN,72293,TOMONI TIMUR,2417,4740,7157
2,KECAMATAN,72287,KALAENA,1809,4287,6096
2,KECAMATAN,72274,TOMONI,0,0,0
2,KECAMATAN,72258,BURAU,4434,10803,15237
2,KECAMATAN,72245,WOTU,4691,10094,14785
2,KECAMATAN,72236,ANGKONA,3714,7983,11697
2,KECAMATAN,72220,MALILI,5040,11226,16266
2,KECAMATAN,72206,TOWUTI,5412,8778,14190
2,KECAMATAN,72200,NUHA,4373,5487,9860
2,KECAMATAN,72302,WASUPONDA,2872,5677,8549
1,KABUPATEN/KOTA,69269,TORAJA UTARA,38720,76165,114885
2,KECAMATAN,69270,RANTEPAO,0,0,0
2,KECAMATAN,69379,BUNTU PEPASAN,2170,6947,9117
2,KECAMATAN,69406,TONDON,2792,3844,6636
2,KECAMATAN,69416,RANTEBUA,1891,4844,6735
2,KECAMATAN,69424,SESEAN SULOARA,963,2682,3645
2,KECAMATAN,69430,KAPALA PITU,795,1823,2618
2,KECAMATAN,69362,TALLUNGLIPU,2886,6013,8899
2,KECAMATAN,69354,BALUSU,1470,3459,4929
2,KECAMATAN,69282,SESEAN,1714,3999,5713
2,KECAMATAN,69292,NANGGALA,2019,3641,5660
2,KECAMATAN,69302,RINDINGALLO,952,3099,4051
2,KECAMATAN,69330,SANGGALANGI,2051,3824,5875
2,KECAMATAN,69337,SOPAI,2535,4009,6544
2,KECAMATAN,69346,TIKALA,1613,3325,4938
2,KECAMATAN,69437,AWAN RANTE KARUA,620,1601,2221
1,KABUPATEN/KOTA,72309,KOTA MAKASSAR,24471,53110,77581
2,KECAMATAN,72310,MARISO,0,0,0
2,KECAMATAN,72449,RAPPOCINI,0,0,0
2,KECAMATAN,72442,MANGGALA,0,0,0
2,KECAMATAN,72434,BIRINGKANAYA,0,0,0
2,KECAMATAN,72423,TAMALATE,0,0,0
2,KECAMATAN,72411,PANAKUKKANG,0,0,0
2,KECAMATAN,72398,UJUNG TANAH,0,0,0
2,KECAMATAN,72382,TALLO,0,0,0
2,KECAMATAN,72369,BONTOALA,0,0,0
2,KECAMATAN,72360,WAJO,0,0,0
2,KECAMATAN,72349,UJUNG PANDANG,0,0,0
2,KECAMATAN,72334,MAKASAR,0,0,0
2,KECAMATAN,72320,MAMAJANG,0,0,0
2,KECAMATAN,72460,TAMALANREA,0,0,0
1,KABUPATEN/KOTA,72467,KOTA PARE PARE,0,0,0
2,KECAMATAN,72468,BACUKIKI,2211,6414,8625
2,KECAMATAN,72472,UJUNG,4720,11915,16635
2,KECAMATAN,72478,SOREANG,5877,17060,22937
2,KECAMATAN,72486,BACUKIKI BARAT,5272,15822,21094
1,KABUPATEN/KOTA,72493,KOTA PALOPO,18080,51211,69291
2,KECAMATAN,72494,WARA,4667,9394,14061
2,KECAMATAN,72501,WARA UTARA,3184,6299,9483
2,KECAMATAN,72508,WARA SELATAN,1634,3401,5035
2,KECAMATAN,72513,TELLUWANUA,2517,3691,6208
2,KECAMATAN,72521,WARA TIMUR,4804,10468,15272
2,KECAMATAN,72529,WARA BARAT,1870,3155,5025
2,KECAMATAN,72535,SENDANA,1057,1987,3044
2,KECAMATAN,72540,MUNGKAJANG,1184,2704,3888
2,KECAMATAN,72545,BARA,4772,7403,12175
0,PROVINSI,72551,SULAWESI TENGGARA,0,0,0
1,KABUPATEN/KOTA,72552,KOLAKA,25689,48502,74191
2,KECAMATAN,72553,WUNDULAKO,6069,3864,9933
2,KECAMATAN,72688,TANGGETADA,2143,4552,6695
2,KECAMATAN,72702,LAMBANDIA,2298,11517,13815
2,KECAMATAN,72723,SAMATURU,3515,6943,10458
2,KECAMATAN,72739,TINONDO,1534,1954,3488
2,KECAMATAN,72757,LALOLAE,976,723,1699
2,KECAMATAN,72763,TOARI,1858,2553,4411
2,KECAMATAN,72770,POLINGGONA,0,0,0
2,KECAMATAN,72680,LATAMBAGA,5256,7933,13189
2,KECAMATAN,72666,ULUIWOI,2552,1296,3848
2,KECAMATAN,72565,TIRAWUTA,3289,3320,6609
2,KECAMATAN,72579,MOWEWE,2756,1322,4078
2,KECAMATAN,72588,KOLAKA,9152,8372,17524
2,KECAMATAN,72596,POMALAA,5687,7541,13228
2,KECAMATAN,72609,WATUBANGGA,2195,5230,7425
2,KECAMATAN,72622,LADONGI,4375,8020,12395
2,KECAMATAN,72636,WOLO,4288,7258,11546
2,KECAMATAN,72656,BAULA,2665,2427,5092
2,KECAMATAN,72777,LOEA,1352,2115,3467
1,KABUPATEN/KOTA,72786,KONAWE,61960,86940,148900
2,KECAMATAN,72787,LAMBUYA,2059,1421,3480
2,KECAMATAN,73010,BESULUTU,2131,1615,3746
2,KECAMATAN,73023,BONDOALA,3001,1547,4548
2,KECAMATAN,73039,ROUTA,277,1540,1817
2,KECAMATAN,73046,ANGGABERI,2966,997,3963
2,KECAMATAN,73052,MELUHU,1340,1460,2800
2,KECAMATAN,73061,AMONGGEDO,2861,2967,5828
2,KECAMATAN,73075,WAWONII TENGAH,558,913,1471
2,KECAMATAN,73083,ASINUA,629,775,1404
2,KECAMATAN,73089,KONAWE,2855,1439,4294
2,KECAMATAN,73099,KAPOIALA,1301,1072,2373
2,KECAMATAN,73110,WAWONII TENGGARA,1987,1312,3299
2,KECAMATAN,73120,WAWONII TIMUR LAUT,1155,795,1950
2,KECAMATAN,73130,LALONGGASUMEETO,1823,945,2768
2,KECAMATAN,72985,WONGGEDUKU,7032,4378,11410
2,KECAMATAN,72968,UEPAI,3743,2935,6678
2,KECAMATAN,72797,UNAAHA,6490,5220,11710
2,KECAMATAN,72807,WAWOTOBI,6238,4360,10598
2,KECAMATAN,72827,PONDIDAHA,3623,2123,5746
2,KECAMATAN,72843,SAMPARA,5154,1800,6954
2,KECAMATAN,72865,WAWONII BARAT,1576,1681,3257
2,KECAMATAN,72874,WAWONII TIMUR,1215,598,1813
2,KECAMATAN,72880,ABUKI,3698,4018,7716
2,KECAMATAN,72897,SOROPIA,2641,1853,4494
2,KECAMATAN,72909,WAWONII SELATAN,1483,841,2324
2,KECAMATAN,72916,WAWONII UTARA,1356,1513,2869
2,KECAMATAN,72926,TONGAUNA,4971,3946,8917
2,KECAMATAN,72944,LATOMA,735,390,1125
2,KECAMATAN,72955,PURIALA,2830,1408,4238
2,KECAMATAN,73141,ONEMBUTE,1772,1676,3448
1,KABUPATEN/KOTA,73150,MUNA,79500,57538,137038
2,KECAMATAN,73151,MAGINTI,0,0,0
2,KECAMATAN,73305,KABAWO,0,0,0
2,KECAMATAN,73317,PARIGI,0,0,0
2,KECAMATAN,73329,BONE,0,0,0
2,KECAMATAN,73335,TONGKUNO,0,0,0
2,KECAMATAN,73348,PASIR PUTIH,0,0,0
2,KECAMATAN,73355,KONTU KOWUNA,0,0,0
2,KECAMATAN,73362,MAROBO,0,0,0
2,KECAMATAN,73368,TONGKUNO SELATAN,0,0,0
2,KECAMATAN,73375,PASI KOLAGA,0,0,0
2,KECAMATAN,73380,BATUKARA,0,0,0
2,KECAMATAN,73385,WA DAGA,0,0,0
2,KECAMATAN,73393,NAPANO KUSAMBI,0,0,0
2,KECAMATAN,73400,TOWEA,0,0,0
2,KECAMATAN,73406,TIWORO SELATAN,0,0,0
2,KECAMATAN,73295,KABANGKA,0,0,0
2,KECAMATAN,73286,LAWA,0,0,0
2,KECAMATAN,73277,BARANGKA,0,0,0
2,KECAMATAN,73160,TIWORO TENGAH,0,0,0
2,KECAMATAN,73169,TIWORO KEPULAUAN,0,0,0
2,KECAMATAN,73179,SEWERGADI,0,0,0
2,KECAMATAN,73190,KUSAMBI,0,0,0
2,KECAMATAN,73201,NAPABALANO,0,0,0
2,KECAMATAN,73208,MALIGANO,0,0,0
2,KECAMATAN,73215,WAKORUMBA SELATAN,0,0,0
2,KECAMATAN,73221,LASALEPA,0,0,0
2,KECAMATAN,73229,BATALAIWARU,0,0,0
2,KECAMATAN,73234,KATOBU,0,0,0
2,KECAMATAN,73243,DURUKA,0,0,0
2,KECAMATAN,73251,LOHIA,0,0,0
2,KECAMATAN,73261,WATOPUTE,0,0,0
2,KECAMATAN,73270,KONTUNAGA,0,0,0
2,KECAMATAN,73412,TIWORO UTARA,0,0,0
1,KABUPATEN/KOTA,73420,BUTON,0,0,0
2,KECAMATAN,73421,MAWASANGKA,0,0,0
2,KECAMATAN,73571,LASALIMU,0,0,0
2,KECAMATAN,73583,LASALIMU SELATAN,0,0,0
2,KECAMATAN,73597,MAWASANGKA TENGAH,0,0,0
2,KECAMATAN,73607,SIOMPU BARAT,0,0,0
2,KECAMATAN,73614,SANGIA WAMBULU,0,0,0
2,KECAMATAN,73621,LAPANDEWA,0,0,0
2,KECAMATAN,73628,WABULA,0,0,0
2,KECAMATAN,73634,WOLOWA,0,0,0
2,KECAMATAN,73554,KAPONTORI,0,0,0
2,KECAMATAN,73546,BATU ATAS,0,0,0
2,KECAMATAN,73537,SIOMPU,0,0,0
2,KECAMATAN,73439,MAWASANGKA TIMUR,0,0,0
2,KECAMATAN,73448,LAKUDO,0,0,0
2,KECAMATAN,73463,G U,0,0,0
2,KECAMATAN,73474,BATAUGA,0,0,0
2,KECAMATAN,73485,SAMPOLAWA,0,0,0
2,KECAMATAN,73498,PASARWAJO,0,0,0
2,KECAMATAN,73519,TELAGA RAYA,0,0,0
2,KECAMATAN,73526,KADATUA,0,0,0
2,KECAMATAN,73640,SIOTAPINA,0,0,0
1,KABUPATEN/KOTA,73650,KONAWE SELATAN,0,0,0
2,KECAMATAN,73651,TINANGGEA,0,0,0
2,KECAMATAN,73891,BENUA,0,0,0
2,KECAMATAN,73904,PALANGGA SELATAN,0,0,0
2,KECAMATAN,73915,MOWILA,0,0,0
2,KECAMATAN,73936,MORAMO UTARA,0,0,0
2,KECAMATAN,73947,BUKE,0,0,0
2,KECAMATAN,73963,WOLASI,0,0,0
2,KECAMATAN,73971,LAEYA,0,0,0
2,KECAMATAN,73989,BAITO,0,0,0
2,KECAMATAN,73998,BASALA,0,0,0
2,KECAMATAN,73872,LALEMBUU,0,0,0
2,KECAMATAN,73851,LAONTI,0,0,0
2,KECAMATAN,73673,ANGATA,0,0,0
2,KECAMATAN,73697,ANDOOLO,0,0,0
2,KECAMATAN,73718,PALANGGA,0,0,0
2,KECAMATAN,73734,LANDONO,0,0,0
2,KECAMATAN,73756,LAINEA,0,0,0
2,KECAMATAN,73769,KONDA,0,0,0
2,KECAMATAN,73786,RANOMEETO,0,0,0
2,KECAMATAN,73799,KOLONO,0,0,0
2,KECAMATAN,73830,MORAMO,0,0,0
2,KECAMATAN,74008,RANOMEETO BARAT,0,0,0
1,KABUPATEN/KOTA,74018,BOMBANA,0,0,0
2,KECAMATAN,74019,POLEANG,2231,4996,7227
2,KECAMATAN,74114,KABAENA SELATAN,1084,552,1636
2,KECAMATAN,74119,KABAENA BARAT,1236,2082,3318
2,KECAMATAN,74125,KABAENA UTARA,760,938,1698
2,KECAMATAN,74132,KABAENA TENGAH,1074,617,1691
2,KECAMATAN,74146,RUMBIA TENGAH,1006,1806,2812
2,KECAMATAN,74152,POLEANG TENGAH,458,1351,1809
2,KECAMATAN,74157,TONTONUNU,689,1808,2497
2,KECAMATAN,74163,LANTARI JAYA,1696,2223,3919
2,KECAMATAN,74109,POLEANG TENGGARA,514,1190,1704
2,KECAMATAN,74103,POLEANG SELATAN,576,2478,3054
2,KECAMATAN,74030,POLEANG TIMUR,1125,3385,4510
2,KECAMATAN,74036,RAROWATU,1281,1257,2538
2,KECAMATAN,74045,RUMBIA,0,0,0
2,KECAMATAN,74051,KABAENA,868,595,1463
2,KECAMATAN,74056,KABAENA TIMUR,1180,1821,3001
2,KECAMATAN,74064,POLEANG BARAT,1927,3664,5591
2,KECAMATAN,74074,MATA OLEO,1537,1406,2943
2,KECAMATAN,74085,RAROWATU UTARA,0,0,0
2,KECAMATAN,74094,POLEANG UTARA,0,0,0
2,KECAMATAN,74173,MATA USU,0,0,0
1,KABUPATEN/KOTA,74179,WAKATOBI,19242,32169,51411
2,KECAMATAN,74201,KALEDUPA,0,0,0
2,KECAMATAN,74218,TOMIA,0,0,0
2,KECAMATAN,74229,BINONGKO,0,0,0
2,KECAMATAN,74239,WANGI WANGI SELATAN,0,0,0
2,KECAMATAN,74261,KALEDUPA SELATAN,0,0,0
2,KECAMATAN,74272,TOMIA TIMUR,0,0,0
2,KECAMATAN,74282,TOGO BINONGKO,0,0,0
1,KABUPATEN/KOTA,74288,KOLAKA UTARA,0,0,0
2,KECAMATAN,74289,LASUSUA,3020,8644,11664
2,KECAMATAN,74422,TIWU,540,1909,2449
2,KECAMATAN,74415,KATOI,711,2519,3230
2,KECAMATAN,74406,POREHU,931,2339,3270
2,KECAMATAN,74396,PAKUE UTARA,927,3044,3971
2,KECAMATAN,74385,PAKUE TENGAH,895,3104,3999
2,KECAMATAN,74376,WATUNOHU,499,3560,4059
2,KECAMATAN,74368,LAMBAI,590,2670,3260
2,KECAMATAN,74360,WAWO,1031,2282,3313
2,KECAMATAN,74347,NGAPA,1919,9334,11253
2,KECAMATAN,74334,KODEOHA,1023,4434,5457
2,KECAMATAN,74326,RANTE ANGIN,653,2181,2834
2,KECAMATAN,74314,BATU PUTIH,1260,3012,4272
2,KECAMATAN,74302,PAKUE,1124,3784,4908
2,KECAMATAN,74430,TOLALA,271,1212,1483
1,KABUPATEN/KOTA,74437,KONAWE UTARA,15394,54028,69422
2,KECAMATAN,74438,ASERA,1910,1849,3759
2,KECAMATAN,83768,ANDOWIA,1320,1884,3204
2,KECAMATAN,83767,OHEO,1325,1200,2525
2,KECAMATAN,74512,SAWA,981,1382,2363
2,KECAMATAN,74502,LEMBO,1399,1208,2607
2,KECAMATAN,74484,LASOLO,2852,3388,6240
2,KECAMATAN,74476,MOLAWE,1110,1803,2913
2,KECAMATAN,74469,LANGGIKIMA,901,1578,2479
2,KECAMATAN,74459,WIWIRANO,1771,2888,4659
2,KECAMATAN,83769,MOTUI,676,1098,1774
1,KABUPATEN/KOTA,74525,BUTON UTARA,14245,18278,32523
2,KECAMATAN,74526,KULISUSU,4343,6871,11214
2,KECAMATAN,74541,KAMBOWA,0,0,0
2,KECAMATAN,74550,BONEGUNU,0,0,0
2,KECAMATAN,74561,KULISUSU BARAT,0,0,0
2,KECAMATAN,74571,KULISUSU UTARA,1765,2416,4181
2,KECAMATAN,74581,WAKORUMBA UTARA,1459,1575,3034
1,KABUPATEN/KOTA,74590,KOTA KENDARI,7567,10862,18429
2,KECAMATAN,74591,MANDONGA,0,0,0
2,KECAMATAN,74649,KADIA,0,0,0
2,KECAMATAN,74642,PUUWATU,0,0,0
2,KECAMATAN,74628,ABELI,0,0,0
2,KECAMATAN,74618,KENDARI BARAT,0,0,0
2,KECAMATAN,74613,POASIA,0,0,0
2,KECAMATAN,74608,BARUGA,0,0,0
2,KECAMATAN,74598,KENDARI,0,0,0
2,KECAMATAN,74660,KAMBU,0,0,0
1,KABUPATEN/KOTA,74665,KOTA BAU BAU,0,0,0
2,KECAMATAN,74666,BETOAMBARI,3826,3905,7731
2,KECAMATAN,74672,WOLIO,0,0,0
2,KECAMATAN,74680,SORA WALIO,1509,1645,3154
2,KECAMATAN,74685,BUNGI,1468,2253,3721
2,KECAMATAN,74691,KOKALUKUNA,3464,4453,7917
2,KECAMATAN,74698,MURHUM,3968,5653,9621
2,KECAMATAN,83766,BATUPOARO,0,0,0
0,PROVINSI,74716,GORONTALO,0,0,0
1,KABUPATEN/KOTA,74717,GORONTALO,14235,17909,32144
2,KECAMATAN,74718,LIMBOTO,18154,7695,25849
2,KECAMATAN,74930,BILATO,3187,2006,5193
2,KECAMATAN,74924,TALAGA JAYA,3584,2442,6026
2,KECAMATAN,74913,ASPARAGA,4625,2337,6962
2,KECAMATAN,74904,BILUHU,2848,1735,4583
2,KECAMATAN,74894,TABONGO,7036,2526,9562
2,KECAMATAN,74885,TILANGO,5072,2470,7542
2,KECAMATAN,74874,LIMBOTO BARAT,10107,3890,13997
2,KECAMATAN,74862,PULUBALA,9765,3247,13012
2,KECAMATAN,74851,MOOTILANGO,6837,3359,10196
2,KECAMATAN,74835,TOLANGOHULA,7907,4655,12562
2,KECAMATAN,74809,BONGOMEME,7864,2855,10719
2,KECAMATAN,74793,TELAGA BIRU,9991,5176,15167
2,KECAMATAN,74779,BOLIYOHUTO,5201,4600,9801
2,KECAMATAN,74769,BATUDAA PANTAI,4207,1771,5978
2,KECAMATAN,74752,TIBAWA,14506,6567,21073
2,KECAMATAN,74743,BATUDAA,5747,2107,7854
2,KECAMATAN,74733,TELAGA,7012,4863,11875
2,KECAMATAN,83777,DUNGALIYO,6484,2888,9372
1,KABUPATEN/KOTA,74941,BOALEMO,140134,67189,207323
2,KECAMATAN,74942,PAGUYAMAN,10782,6992,17774
2,KECAMATAN,74965,WONOSARI,8151,7155,15306
2,KECAMATAN,74980,DULUPI,4729,3831,8560
2,KECAMATAN,74989,TILAMUTA,8771,6857,15628
2,KECAMATAN,75002,MANANGGU,3588,3009,6597
2,KECAMATAN,75012,BOTUMOITO,4685,3330,8015
2,KECAMATAN,75022,PAGUYAMAN PANTAI,2423,2005,4428
1,KABUPATEN/KOTA,75031,BONE BOLANGO,43129,33179,76308
2,KECAMATAN,75032,TAPA,3039,1168,4207
2,KECAMATAN,75176,BULAWA,2047,685,2732
2,KECAMATAN,75170,BULANGO TIMUR,2222,977,3199
2,KECAMATAN,75161,BULANGO SELATAN,3866,2137,6003
2,KECAMATAN,75154,BULANGO ULU,1510,592,2102
2,KECAMATAN,75148,SUWAWA TENGAH,2045,1332,3377
2,KECAMATAN,75141,SUWAWA SELATAN,1479,1349,2828
2,KECAMATAN,75134,SUWAWA TIMUR,1662,1279,2941
2,KECAMATAN,75123,BONE,3266,1763,5029
2,KECAMATAN,75114,BONE RAYA,2360,1251,3611
2,KECAMATAN,75104,KABILA BONE,3510,2244,5754
2,KECAMATAN,75097,BOTUPINGGE,2444,1136,3580
2,KECAMATAN,75085,TILONGKABILA,6466,3674,10140
2,KECAMATAN,75075,BULANGO UTARA,2877,1386,4263
2,KECAMATAN,75062,BONEPANTAI,3727,1823,5550
2,KECAMATAN,75053,SUWAWA,4027,2585,6612
2,KECAMATAN,75040,KABILA,7763,4896,12659
2,KECAMATAN,83776,PINOGU,685,397,1082
1,KABUPATEN/KOTA,75183,PAHUWATO,54995,30674,85669
2,KECAMATAN,75184,POPAYATO,3062,2237,5299
2,KECAMATAN,75285,POPAYATO TIMUR,2253,2060,4313
2,KECAMATAN,75277,WANGGARASI,1226,1326,2552
2,KECAMATAN,75268,DUHIADAA,3139,2648,5787
2,KECAMATAN,75260,BUNTULIA,2705,3056,5761
2,KECAMATAN,75254,DENGILO,1928,1176,3104
2,KECAMATAN,75246,TALUDITI,2192,2057,4249
2,KECAMATAN,75239,PATILANGGIO,3043,1744,4787
2,KECAMATAN,75227,PAGUAT,5011,3582,8593
2,KECAMATAN,75218,MARISA,4492,4063,8555
2,KECAMATAN,75204,RANDANGAN,4290,4193,8483
2,KECAMATAN,75195,LEMITO,3154,2089,5243
2,KECAMATAN,75293,POPAYATO BARAT,1448,1895,3343
1,KABUPATEN/KOTA,75301,GORONTALO UTARA,37943,32126,70069
2,KECAMATAN,75302,ATINGGOLA,3974,2150,6124
2,KECAMATAN,83774,BIAU,1488,1291,2779
2,KECAMATAN,83773,MONANO,2260,1335,3595
2,KECAMATAN,83772,PONELO KEPULAUAN,1711,393,2104
2,KECAMATAN,83771,TOMOLITO,3290,1301,4591
2,KECAMATAN,83770,GENTUMA RAYA,3223,1648,4871
2,KECAMATAN,75352,TOLINGGULA,3435,1484,4919
2,KECAMATAN,75341,SUMALATA,3578,2145,5723
2,KECAMATAN,75330,ANGGREK,5536,2475,8011
2,KECAMATAN,75315,KWANDANG,9413,4548,13961
2,KECAMATAN,83775,SUMALATA TIMUR,2361,1391,3752
1,KABUPATEN/KOTA,75365,KOTA GORONTALO,40269,20161,60430
2,KECAMATAN,75366,KOTA BARAT,7928,3996,11924
2,KECAMATAN,75374,KOTA SELATAN,6363,4487,10850
2,KECAMATAN,75380,KOTA UTARA,6437,3536,9973
2,KECAMATAN,75387,DUNGINGI,6624,5148,11772
2,KECAMATAN,75393,KOTA TIMUR,9066,4758,13824
2,KECAMATAN,75400,KOTA TENGAH,8447,5045,13492
2,KECAMATAN,75407,SIPATANA,5745,3746,9491
2,KECAMATAN,75413,DUMBO RAYA,5948,3991,9939
2,KECAMATAN,75419,HULONTHALANGI,5707,3461,9168
0,PROVINSI,75425,SULAWESI BARAT,0,0,0
1,KABUPATEN/KOTA,75426,MAMUJU UTARA,62265,38168,100433
2,KECAMATAN,75427,BAMBALAMOTU,0,0,0
2,KECAMATAN,75489,SARJO,0,0,0
2,KECAMATAN,75484,BAMBAIRA,0,0,0
2,KECAMATAN,75479,PEDONGGA,0,0,0
2,KECAMATAN,75473,TIKKE RAYA,0,0,0
2,KECAMATAN,75465,BULU TABA,0,0,0
2,KECAMATAN,75460,DURIPOKU,0,0,0
2,KECAMATAN,75454,DAPURANG,0,0,0
2,KECAMATAN,75448,SARUDU,0,0,0
2,KECAMATAN,75441,BARAS,0,0,0
2,KECAMATAN,75434,PASANGKAYU,0,0,0
2,KECAMATAN,75494,LARIANG,0,0,0
1,KABUPATEN/KOTA,75502,MAMUJU,0,0,0
2,KECAMATAN,75503,MAMUJU,0,0,0
2,KECAMATAN,75660,BONEHAU,0,0,0
2,KECAMATAN,75651,TOBADAK,0,0,0
2,KECAMATAN,75643,TAPALANG BARAT,0,0,0
2,KECAMATAN,75632,SIMBORO DAN KEPULAUAN,0,0,0
2,KECAMATAN,75617,TOMMO,0,0,0
2,KECAMATAN,75605,KAROSSA,0,0,0
2,KECAMATAN,75589,TOPOYO,0,0,0
2,KECAMATAN,75581,SAMPAGA,0,0,0
2,KECAMATAN,75571,PAPALANG,0,0,0
2,KECAMATAN,75561,PANGALE,0,0,0
2,KECAMATAN,75536,KALUMPANG,0,0,0
2,KECAMATAN,75522,KALUKKU,0,0,0
2,KECAMATAN,75512,TAPALANG,0,0,0
1,KABUPATEN/KOTA,75670,MAMASA,0,0,0
2,KECAMATAN,75671,MAMBI,0,0,0
2,KECAMATAN,83761,BUNTUMALANGKA,0,0,0
2,KECAMATAN,75854,RANTEBULAHAN TIMUR,0,0,0
2,KECAMATAN,75849,TAWALIAN,0,0,0
2,KECAMATAN,75841,NOSU,0,0,0
2,KECAMATAN,75832,BALLA,0,0,0
2,KECAMATAN,75811,BAMBANG,0,0,0
2,KECAMATAN,75803,TABANG,0,0,0
2,KECAMATAN,75790,TANDUK KALUA,0,0,0
2,KECAMATAN,75779,SESENAPADANG,0,0,0
2,KECAMATAN,75769,MESSAWA,0,0,0
2,KECAMATAN,75758,SUMARORONG,0,0,0
2,KECAMATAN,75743,TABULAHAN,0,0,0
2,KECAMATAN,75729,PANA,0,0,0
2,KECAMATAN,75716,MAMASA,0,0,0
2,KECAMATAN,75693,ARALLE,0,0,0
2,KECAMATAN,83762,MEHALAAN,0,0,0
1,KABUPATEN/KOTA,75863,POLEWALI MANDAR,0,0,0
2,KECAMATAN,75864,TINAMBUNG,3624,8106,11730
2,KECAMATAN,76028,ALLU,2547,3695,6242
2,KECAMATAN,76020,MATAKALI,3423,7550,10973
2,KECAMATAN,76014,ANREAPI,1398,3518,4916
2,KECAMATAN,76002,BALANIPA,3782,8701,12483
2,KECAMATAN,75990,LIMBORO,3732,5292,9024
2,KECAMATAN,75978,LUYO,4264,8575,12839
2,KECAMATAN,75970,MATANGNGA,1040,1425,2465
2,KECAMATAN,75957,MAPILLI,4620,9179,13799
2,KECAMATAN,75942,TAPANGO,3682,7334,11016
2,KECAMATAN,75931,BINUANG,3789,11784,15573
2,KECAMATAN,75917,TUTAR,2839,6572,9411
2,KECAMATAN,75907,POLEWALI,8007,18529,26536
2,KECAMATAN,75892,WONOMULYO,10196,15291,25487
2,KECAMATAN,75873,CAMPALAGIAN,8922,16828,25750
2,KECAMATAN,76037,BULO,1512,4050,5562
1,KABUPATEN/KOTA,76047,MAJENE,67377,136429,203806
2,KECAMATAN,76048,BANGGAE,5096,15333,20429
2,KECAMATAN,76053,PAMBOANG,2158,9094,11252
2,KECAMATAN,76061,SENDANA,2895,8480,11375
2,KECAMATAN,76068,MALUNDA,1787,6936,8723
2,KECAMATAN,76075,ULUMUNDA,900,3560,4460
2,KECAMATAN,76080,TAMMERODO SENDANA,1240,4649,5889
2,KECAMATAN,76085,TUBO SENDANA,1160,3598,4758
2,KECAMATAN,76090,BANGGAE TIMUR,3935,11203,15138
0,PROVINSI,76096,MALUKU,0,0,0
1,KABUPATEN/KOTA,76284,MALUKU TENGAH,19171,62853,82024
2,KECAMATAN,76285,AMAHAI,0,0,0
2,KECAMATAN,83814,SERAM UTARA TIMUR KOBI,0,0,0
2,KECAMATAN,83813,SERAM UTARA TIMUR SETI,0,0,0
2,KECAMATAN,83812,TELUTIH,0,0,0
2,KECAMATAN,76464,LEIHITU BARAT,0,0,0
2,KECAMATAN,76456,TELUK ELPAPUTIH,0,0,0
2,KECAMATAN,76443,SERAM UTARA BARAT,0,0,0
2,KECAMATAN,76437,KOTA MASOHI,0,0,0
2,KECAMATAN,76429,NUSA LAUT,0,0,0
2,KECAMATAN,76417,LEIHITU,0,0,0
2,KECAMATAN,76410,SALAHUTU,0,0,0
2,KECAMATAN,76398,PULAU HARUKU,0,0,0
2,KECAMATAN,76381,SAPARUA,0,0,0
2,KECAMATAN,76360,TEHORU,0,0,0
2,KECAMATAN,76347,BANDA,0,0,0
2,KECAMATAN,76315,SERAM UTARA,0,0,0
2,KECAMATAN,76297,TEON NILA SERUA,0,0,0
2,KECAMATAN,83815,SAPARUA TIMUR,0,0,0
1,KABUPATEN/KOTA,76470,MALUKU TENGGARA,0,0,0
2,KECAMATAN,76471,KEI KECIL,0,0,0
2,KECAMATAN,76494,KEI BESAR,0,0,0
2,KECAMATAN,76516,KEI BESAR SELATAN,0,0,0
2,KECAMATAN,76531,KEI BESAR UTARA TIMUR,0,0,0
2,KECAMATAN,76545,KEI KECIL TIMUR,0,0,0
2,KECAMATAN,76559,KEI KECIL BARAT,0,0,0
1,KABUPATEN/KOTA,76568,MALUKU TENGGARA BARAT,0,0,0
2,KECAMATAN,76569,TANIMBAR SELATAN,0,0,0
2,KECAMATAN,76645,NIRUNMAS,0,0,0
2,KECAMATAN,76635,KORMOMOLIN,0,0,0
2,KECAMATAN,76622,WUAR LABOBAR,0,0,0
2,KECAMATAN,76615,YARU,0,0,0
2,KECAMATAN,76606,TANIMBAR UTARA,0,0,0
2,KECAMATAN,76597,WER MAKTIAN,0,0,0
2,KECAMATAN,76588,WER TAMRIAN,0,0,0
2,KECAMATAN,76581,SELARU,0,0,0
2,KECAMATAN,83821,MOLU MARU,0,0,0
1,KABUPATEN/KOTA,76651,BURU,0,0,0
2,KECAMATAN,76652,NAMLEA,13529,4749,18278
2,KECAMATAN,83825,TELUK KAIELY,1790,617,2407
2,KECAMATAN,83824,WAELATA,3958,2549,6507
2,KECAMATAN,83823,LOLONG GUBA,3867,2147,6014
2,KECAMATAN,83822,FENA LEISELA,0,0,0
2,KECAMATAN,76702,BATABUAL,2898,2078,4976
2,KECAMATAN,76692,WAPLAU,3621,2139,5760
2,KECAMATAN,76673,WAEAPO,0,0,0
2,KECAMATAN,76664,AIR BUAYA,0,0,0
2,KECAMATAN,83826,LILIALY,3961,1376,5337
1,KABUPATEN/KOTA,76708,SERAM BAGIAN TIMUR,33624,15655,49279
2,KECAMATAN,76709,BULA,0,0,0
2,KECAMATAN,83834,SIRITAUN WIDA TIMUR,0,0,0
2,KECAMATAN,83833,KIAN DARAT,0,0,0
2,KECAMATAN,83832,BULA BARAT,0,0,0
2,KECAMATAN,83831,GOROM TIMUR,0,0,0
2,KECAMATAN,83830,TEOR,0,0,0
2,KECAMATAN,83829,PULAU PANJANG,0,0,0
2,KECAMATAN,83828,KILMURY,0,0,0
2,KECAMATAN,83827,SIWALALAT,0,0,0
2,KECAMATAN,76763,TUTUK TOLU,0,0,0
2,KECAMATAN,76753,WAKATE,0,0,0
2,KECAMATAN,76741,PULAU GORONG,0,0,0
2,KECAMATAN,76730,WERINAMA,0,0,0
2,KECAMATAN,76719,SERAM TIMUR,0,0,0
2,KECAMATAN,83835,TELUK WARU,0,0,0
1,KABUPATEN/KOTA,76771,SERAM BAGIAN BARAT,0,0,0
2,KECAMATAN,76772,KAIRATU,208,208,416
2,KECAMATAN,83841,ELPAPUTIH,605,1607,2212
2,KECAMATAN,83840,TANIWEL TIMUR,1231,1830,3061
2,KECAMATAN,83839,KEPULAUAN MANIPA,3365,1261,4626
2,KECAMATAN,83838,KAIRATU BARAT,0,0,0
2,KECAMATAN,83837,INAMOSOL,0,0,0
2,KECAMATAN,83836,AMALATU,5061,3497,8558
2,KECAMATAN,76850,HUAMUAL,0,0,0
2,KECAMATAN,76815,TANIWEL,3237,3580,6817
2,KECAMATAN,76802,SERAM BARAT,0,0,0
2,KECAMATAN,91360,HUAMUAL BELAKANG,8647,5142,13789
1,KABUPATEN/KOTA,76868,KEPULAUAN ARU,22354,17125,39479
2,KECAMATAN,83842,ARU UTARA TIMUR BATULEY,1112,1117,2229
2,KECAMATAN,76982,ARU SELATAN TIMUR,698,1376,2074
2,KECAMATAN,76974,ARU TENGAH SELATAN,1040,1647,2687
2,KECAMATAN,76960,ARU TENGAH TIMUR,630,1622,2252
2,KECAMATAN,76930,ARU UTARA,982,1936,2918
2,KECAMATAN,76906,ARU TENGAH,1244,4924,6168
2,KECAMATAN,76886,ARU SELATAN,764,2512,3276
2,KECAMATAN,83844,ARU SELATAN UTARA,593,1478,2071
1,KABUPATEN/KOTA,76097,MALUKU BARAT DAYA,7063,16612,23675
2,KECAMATAN,76098,MOA LAKOR,0,0,0
2,KECAMATAN,76111,DAMER,738,1964,2702
2,KECAMATAN,76119,MNDONA HIERA,0,0,0
2,KECAMATAN,76178,WETAR,0,0,0
2,KECAMATAN,76215,PULAU LETI,0,0,0
1,KABUPATEN/KOTA,76223,BURU SELATAN,738,1964,2702
2,KECAMATAN,76224,NAMROLE,0,0,0
2,KECAMATAN,76235,WAESAMA,0,0,0
2,KECAMATAN,76244,AMBALAU,0,0,0
2,KECAMATAN,76252,KEPALA MADAN,0,0,0
2,KECAMATAN,76263,LEKSULA,0,0,0
2,KECAMATAN,83857,FENA FAFAN,0,0,0
1,KABUPATEN/KOTA,76995,KOTA AMBON,0,0,0
2,KECAMATAN,76996,NUSANIWE,0,0,0
2,KECAMATAN,77010,SIRIMAU,0,0,0
2,KECAMATAN,77025,BAGUALA,8360,18007,26367
2,KECAMATAN,77033,TELUK AMBON,0,0,0
2,KECAMATAN,77042,LEITIMUR SELATAN,0,0,0
1,KABUPATEN/KOTA,77051,KOTA TUAL,8360,18007,26367
2,KECAMATAN,77052,PULAU DULLAH UTARA,0,0,0
2,KECAMATAN,77061,PULAU DULLAH SELATAN,0,0,0
2,KECAMATAN,77067,TAYANDO TAM,0,0,0
2,KECAMATAN,83858,KUR SELATAN,0,0,0
0,PROVINSI,77085,MALUKU UTARA,0,0,0
1,KABUPATEN/KOTA,77155,HALMAHERA BARAT,0,0,0
2,KECAMATAN,77156,JAILOLO,8332,6946,15278
2,KECAMATAN,77186,LOLODA,2455,3894,6349
2,KECAMATAN,77209,IBU,3183,2284,5467
2,KECAMATAN,77223,SAHU,2319,3286,5605
2,KECAMATAN,77240,JAILOLO SELATAN,0,0,0
2,KECAMATAN,77259,JAILOLO TIMUR,0,0,0
2,KECAMATAN,77266,IBU UTARA,1816,2651,4467
2,KECAMATAN,77280,IBU SELATAN,2519,3094,5613
2,KECAMATAN,77294,SAHU TIMUR,1501,3227,4728
1,KABUPATEN/KOTA,77311,HALMAHERA TENGAH,22125,25382,47507
2,KECAMATAN,77312,WEDA,1581,1949,3530
2,KECAMATAN,77322,PATANI,0,0,0
2,KECAMATAN,77332,PULAU GEBE,1510,1291,2801
2,KECAMATAN,77339,WEDA UTARA,0,0,0
2,KECAMATAN,77347,WEDA SELATAN,1230,1594,2824
2,KECAMATAN,77355,PATANI UTARA,3074,3098,6172
2,KECAMATAN,83859,WEDA TENGAH,985,1028,2013
2,KECAMATAN,83860,PATANI BARAT,1163,1006,2169
1,KABUPATEN/KOTA,77364,HALMAHERA UTARA,9543,9966,19509
2,KECAMATAN,77365,GALELA,0,0,0
2,KECAMATAN,77544,KAO BARAT,0,0,0
2,KECAMATAN,77531,KAO UTARA,0,0,0
2,KECAMATAN,77520,LOLODA KEPULAUAN,0,0,0
2,KECAMATAN,77512,GALELA SELATAN,0,0,0
2,KECAMATAN,77499,GALELA UTARA,0,0,0
2,KECAMATAN,77489,GALELA BARAT,0,0,0
2,KECAMATAN,77483,TOBELO BARAT,0,0,0
2,KECAMATAN,77476,TOBELO TIMUR,0,0,0
2,KECAMATAN,77466,TOBELO TENGAH,0,0,0
2,KECAMATAN,77455,TOBELO UTARA,0,0,0
2,KECAMATAN,77436,LOLODA UTARA,0,0,0
2,KECAMATAN,77413,MALIFUT,0,0,0
2,KECAMATAN,77398,KAO,0,0,0
2,KECAMATAN,77384,TOBELO SELATAN,0,0,0
2,KECAMATAN,77373,TOBELO,0,0,0
2,KECAMATAN,77566,KAO TELUK,0,0,0
1,KABUPATEN/KOTA,77578,HALMAHERA SELATAN,0,0,0
2,KECAMATAN,77579,PULAU MAKIAN,4944,3019,7963
2,KECAMATAN,77743,BACAN SELATAN,0,0,0
2,KECAMATAN,77754,KEPULAUAN BOTANGLOMANG,2122,1619,3741
2,KECAMATAN,77763,MANDIOLI SELATAN,1612,1124,2736
2,KECAMATAN,77770,MANDIOLI UTARA,0,0,0
2,KECAMATAN,77777,BACAN TIMUR SELATAN,1834,1245,3079
2,KECAMATAN,77785,BACAN TIMUR TENGAH,2572,1502,4074
2,KECAMATAN,77793,GANE BARAT SELATAN,0,0,0
2,KECAMATAN,77802,GANE BARAT UTARA,2295,948,3243
2,KECAMATAN,77815,KEPULAUAN JORONGA,1981,1021,3002
2,KECAMATAN,77823,GANE TIMUR SELATAN,0,0,0
2,KECAMATAN,77829,GANE TIMUR TENGAH,0,0,0
2,KECAMATAN,77838,OBI BARAT,0,0,0
2,KECAMATAN,77845,OBI TIMUR,0,0,0
2,KECAMATAN,77734,KASIRUTA TIMUR,1045,1073,2118
2,KECAMATAN,77723,KASIRUTA BARAT,0,0,0
2,KECAMATAN,77595,KAYOA,3094,1459,4553
2,KECAMATAN,77610,GANE TIMUR,2097,2460,4557
2,KECAMATAN,77623,GANE BARAT,0,0,0
2,KECAMATAN,77634,OBI SELATAN,0,0,0
2,KECAMATAN,77643,OBI,3631,3040,6671
2,KECAMATAN,77653,BACAN TIMUR,0,0,0
2,KECAMATAN,77664,BACAN,4538,3794,8332
2,KECAMATAN,77679,BACAN BARAT,1603,804,2407
2,KECAMATAN,77687,MAKIAN BARAT,1925,405,2330
2,KECAMATAN,77695,KAYOA BARAT,1667,689,2356
2,KECAMATAN,77700,KAYOA SELATAN,1711,1448,3159
2,KECAMATAN,77707,KAYOA UTARA,1172,648,1820
2,KECAMATAN,77714,BACAN BARAT UTARA,0,0,0
2,KECAMATAN,77850,OBI UTARA,0,0,0
1,KABUPATEN/KOTA,77858,KEPULAUAN SULA,39843,26298,66141
2,KECAMATAN,77859,MANGOLI TIMUR,0,0,0
2,KECAMATAN,77948,SANANA UTARA,0,0,0
2,KECAMATAN,77942,TALIABU SELATAN,0,0,0
2,KECAMATAN,77940,TALIABU BARAT LAUT,0,0,0
2,KECAMATAN,77932,TALIABU UTARA,0,0,0
2,KECAMATAN,77925,MANGOLI UTARA,0,0,0
2,KECAMATAN,77920,MANGOLI SELATAN,0,0,0
2,KECAMATAN,77914,MANGOLI TENGAH,0,0,0
2,KECAMATAN,77910,MANGOLI UTARA TIMUR,0,0,0
2,KECAMATAN,77906,SULABESI SELATAN,0,0,0
2,KECAMATAN,77901,SULABESI TIMUR,0,0,0
2,KECAMATAN,77895,SULABESI TENGAH,0,0,0
2,KECAMATAN,77890,MANGOLI BARAT,0,0,0
2,KECAMATAN,77884,TALIABU TIMUR SELATAN,0,0,0
2,KECAMATAN,77879,TALIABU BARAT,0,0,0
2,KECAMATAN,77875,SULABESI BARAT,0,0,0
2,KECAMATAN,77863,SANANA,0,0,0
2,KECAMATAN,77952,LEDE,0,0,0
1,KABUPATEN/KOTA,77956,HALMAHERA TIMUR,0,0,0
2,KECAMATAN,77957,WASILE,0,0,0
2,KECAMATAN,78026,MABA UTARA,0,0,0
2,KECAMATAN,78017,MABA TENGAH,0,0,0
2,KECAMATAN,78010,WASILE TIMUR,0,0,0
2,KECAMATAN,78003,WASILE UTARA,0,0,0
2,KECAMATAN,77994,WASILE TENGAH,0,0,0
2,KECAMATAN,77979,WASILE SELATAN,0,0,0
2,KECAMATAN,77972,MABA SELATAN,0,0,0
2,KECAMATAN,77964,MABA,0,0,0
2,KECAMATAN,78034,KOTA MABA,0,0,0
1,KABUPATEN/KOTA,77086,PULAU MOROTAI,0,0,0
2,KECAMATAN,77087,MOROTAI SELATAN,0,0,0
2,KECAMATAN,77108,MOROTAI SELATAN BARAT,0,0,0
2,KECAMATAN,77126,MOROTAI JAYA,0,0,0
2,KECAMATAN,77136,MOROTAI UTARA,0,0,0
2,KECAMATAN,77146,MOROTAI TIMUR,0,0,0
1,KABUPATEN/KOTA,78040,KOTA TERNATE,0,0,0
2,KECAMATAN,78041,PULAU TERNATE,0,0,0
2,KECAMATAN,78059,KOTA TERNATE SELATAN,0,0,0
2,KECAMATAN,78077,KOTA TERNATE UTARA,0,0,0
2,KECAMATAN,78092,PULAU MOTI,0,0,0
2,KECAMATAN,78099,PULAU BATANG DUA,0,0,0
2,KECAMATAN,78106,KOTA TERNATE TENGAH,0,0,0
2,KECAMATAN,83861,PULAU HIRI,0,0,0
1,KABUPATEN/KOTA,78122,KOTA TIDORE KEPULAUAN,0,0,0
2,KECAMATAN,78123,TIDORE,4815,4765,9580
2,KECAMATAN,78135,OBA UTARA,3989,3526,7515
2,KECAMATAN,78148,OBA,3709,2789,6498
2,KECAMATAN,78158,TIDORE SELATAN,4054,3388,7442
2,KECAMATAN,78167,TIDORE UTARA,4878,4178,9056
2,KECAMATAN,78180,OBA TENGAH,2248,2017,4265
2,KECAMATAN,78190,OBA SELATAN,1489,1272,2761
2,KECAMATAN,78198,TIDORE TIMUR,2489,1905,4394
0,PROVINSI,78203,PAPUA,0,0,0
1,KABUPATEN/KOTA,79826,MERAUKE,27671,23840,51511
2,KECAMATAN,79827,MERAUKE,0,0,0
2,KECAMATAN,79953,NAUKENJERAI,0,0,0
2,KECAMATAN,79959,KAPTEL,0,0,0
2,KECAMATAN,79964,TUBANG,0,0,0
2,KECAMATAN,79971,NGGUTI,0,0,0
2,KECAMATAN,79977,TABONJI,0,0,0
2,KECAMATAN,79987,WAAN,0,0,0
2,KECAMATAN,79996,ILWAYAB,0,0,0
2,KECAMATAN,80001,MALIND,0,0,0
2,KECAMATAN,79943,KURIK,0,0,0
2,KECAMATAN,79930,ELIKOBAL,0,0,0
2,KECAMATAN,79838,MUTING,0,0,0
2,KECAMATAN,79851,OKABA,0,0,0
2,KECAMATAN,79860,KIMAAM,0,0,0
2,KECAMATAN,79872,SEMANGGA,0,0,0
2,KECAMATAN,79883,TANAH MIRING,0,0,0
2,KECAMATAN,79897,JAGEBOB,0,0,0
2,KECAMATAN,79912,SOTA,0,0,0
2,KECAMATAN,79918,ULILIN,0,0,0
2,KECAMATAN,80009,ANIMHA,0,0,0
1,KABUPATEN/KOTA,80015,JAYAWIJAYA,0,0,0
2,KECAMATAN,80016,WAMENA,0,0,0
2,KECAMATAN,83603,MOLAGALOME,0,0,0
2,KECAMATAN,83602,TAGIME,0,0,0
2,KECAMATAN,83601,KORAGI,0,0,0
2,KECAMATAN,83600,PISUGI,0,0,0
2,KECAMATAN,83599,WADANGKU,0,0,0
2,KECAMATAN,83598,LIBAREK,0,0,0
2,KECAMATAN,83596,USILIMO,0,0,0
2,KECAMATAN,83595,SIEPKOSI,0,0,0
2,KECAMATAN,83604,TAGINERI,0,0,0
2,KECAMATAN,83605,SILO KARNO DOGA,0,0,0
2,KECAMATAN,84091,WITA WAYA,0,0,0
2,KECAMATAN,83612,MAIMA,0,0,0
2,KECAMATAN,83611,ASOTIPO,0,0,0
2,KECAMATAN,83610,WELESI,0,0,0
2,KECAMATAN,83609,BIPIRI,0,0,0
2,KECAMATAN,83608,BUGI,0,0,0
2,KECAMATAN,83607,MULIAMA,0,0,0
2,KECAMATAN,83606,PIRAMID,0,0,0
2,KECAMATAN,83594,ITLAY HISAGE,0,0,0
2,KECAMATAN,83593,TAELAREK,0,0,0
2,KECAMATAN,80113,BOLAKME,0,0,0
2,KECAMATAN,80100,PELEBAGA,0,0,0
2,KECAMATAN,80094,HUBIKOSI,0,0,0
2,KECAMATAN,80085,WALELAGAMA,0,0,0
2,KECAMATAN,80075,ASOLOKOBAL,0,0,0
2,KECAMATAN,80070,MUSATFAK,0,0,0
2,KECAMATAN,80052,KURULU,0,0,0
2,KECAMATAN,80031,ASOLOGAIMA,0,0,0
2,KECAMATAN,80129,YALENGGA,0,0,0
2,KECAMATAN,80135,WOLO,0,0,0
2,KECAMATAN,83592,IBELE,0,0,0
2,KECAMATAN,83591,HUBIKIAK,0,0,0
2,KECAMATAN,83590,WOUMA,0,0,0
2,KECAMATAN,83589,WALAIK,0,0,0
2,KECAMATAN,83588,NAPUA,0,0,0
2,KECAMATAN,83587,TRIKORA,0,0,0
2,KECAMATAN,83586,WESAPUT,0,0,0
2,KECAMATAN,83585,WAME,0,0,0
2,KECAMATAN,84093,POPUGOBA,0,0,0
1,KABUPATEN/KOTA,80144,JAYAPURA,0,0,0
2,KECAMATAN,80145,SENTANI,18424,24796,43220
2,KECAMATAN,80298,GRESI  SELATAN,25,676,701
2,KECAMATAN,80293,RAVENI RARA,134,1652,1786
2,KECAMATAN,80283,AIRU,216,861,1077
2,KECAMATAN,80273,YAPSI,1907,1188,3095
2,KECAMATAN,80263,NAMBLUONG,952,1142,2094
2,KECAMATAN,80255,WAIBU,2437,5828,8265
2,KECAMATAN,80249,EBUNGFA,320,1383,1703
2,KECAMATAN,80244,KAUREH,2068,4892,6960
2,KECAMATAN,80236,DEMTA,308,1488,1796
2,KECAMATAN,80229,UNURUM GUAY,250,1137,1387
2,KECAMATAN,80219,NIMBOKRANG,2555,1419,3974
2,KECAMATAN,80204,NIMBORAN,470,2553,3023
2,KECAMATAN,80191,KEMTUK GRESI,301,2260,2561
2,KECAMATAN,80179,KEMTUK,472,2063,2535
2,KECAMATAN,80173,SENTANI BARAT,637,1431,2068
2,KECAMATAN,80164,DEPAPRE,489,1968,2457
2,KECAMATAN,80156,SENTANI TIMUR,950,3343,4293
2,KECAMATAN,80303,YOKARI,161,1260,1421
1,KABUPATEN/KOTA,80309,NABIRE,33076,61340,94416
2,KECAMATAN,80310,NABIRE,0,0,0
2,KECAMATAN,83614,DIPA,0,0,0
2,KECAMATAN,83613,MOORA,0,0,0
2,KECAMATAN,80396,NABIRE BARAT,0,0,0
2,KECAMATAN,80392,WAPOGA,0,0,0
2,KECAMATAN,80385,YARO,0,0,0
2,KECAMATAN,80379,TELUK KIMI,0,0,0
2,KECAMATAN,80374,TELUK UMAR,0,0,0
2,KECAMATAN,80367,MAKIMI,0,0,0
2,KECAMATAN,80360,SIRIWO,0,0,0
2,KECAMATAN,80354,WANGGAR,0,0,0
2,KECAMATAN,80337,UWAPA,0,0,0
2,KECAMATAN,80332,YAUR,0,0,0
2,KECAMATAN,80323,NAPAN,0,0,0
2,KECAMATAN,83615,MENOU,0,0,0
1,KABUPATEN/KOTA,80402,KEPULAUAN YAPEN,0,0,0
2,KECAMATAN,80403,YAPEN SELATAN,0,0,0
2,KECAMATAN,83616,PULAU KURUDU,0,0,0
2,KECAMATAN,80517,WINDESI,0,0,0
2,KECAMATAN,80510,WONAWA,0,0,0
2,KECAMATAN,80499,KEPULAUAN AMBAI,0,0,0
2,KECAMATAN,80489,TELUK AMPIMOI,0,0,0
2,KECAMATAN,80477,RAIMBAWI,0,0,0
2,KECAMATAN,80470,YAPEN UTARA,0,0,0
2,KECAMATAN,80459,KOSIWO,0,0,0
2,KECAMATAN,80452,POOM,0,0,0
2,KECAMATAN,80437,ANGKAISERA,0,0,0
2,KECAMATAN,80427,YAPEN TIMUR,0,0,0
2,KECAMATAN,80418,YAPEN BARAT,0,0,0
2,KECAMATAN,83617,PULAU YERUI,0,0,0
1,KABUPATEN/KOTA,80526,BIAK NUMFOR,0,0,0
2,KECAMATAN,80527,BIAK KOTA,0,0,0
2,KECAMATAN,83625,ORIDEK,0,0,0
2,KECAMATAN,83624,AIMANDO PADAIDO,0,0,0
2,KECAMATAN,83623,POIRU,0,0,0
2,KECAMATAN,83622,ORKERI,0,0,0
2,KECAMATAN,83621,BRUYADORI,0,0,0
2,KECAMATAN,83620,SWANDIWE,0,0,0
2,KECAMATAN,83619,ANDEY,0,0,0
2,KECAMATAN,83618,YAWOSI,0,0,0
2,KECAMATAN,80713,SAMOFA,0,0,0
2,KECAMATAN,80698,YENDIDORI,0,0,0
2,KECAMATAN,80678,PADAIDO,0,0,0
2,KECAMATAN,80657,WARSA,0,0,0
2,KECAMATAN,80628,BIAK BARAT,0,0,0
2,KECAMATAN,80612,NUMFOR TIMUR,0,0,0
2,KECAMATAN,80593,NUMFOR BARAT,0,0,0
2,KECAMATAN,80562,BIAK TIMUR,0,0,0
2,KECAMATAN,80543,BIAK UTARA,0,0,0
2,KECAMATAN,83862,BONDIFUAR,0,0,0
1,KABUPATEN/KOTA,80724,PUNCAK JAYA,0,0,0
2,KECAMATAN,80725,MULIA,0,0,0
2,KECAMATAN,80781,ILU,0,0,0
2,KECAMATAN,80839,FAWI,1971,3239,5210
2,KECAMATAN,83632,MEWOLUK,905,12044,12949
2,KECAMATAN,83633,YAMO,0,0,0
2,KECAMATAN,83635,JIGONIKME,0,0,0
2,KECAMATAN,83636,TORERE,3000,3807,6807
2,KECAMATAN,83637,TINGGINAMBUT,2120,26686,28806
1,KABUPATEN/KOTA,80851,PANIAI,7996,45776,53772
2,KECAMATAN,80852,PANIAI TIMUR,0,0,0
2,KECAMATAN,80956,SIRIWO,0,0,0
2,KECAMATAN,80960,BOWOBADO,0,0,0
2,KECAMATAN,80964,KAPIRAYA,0,0,0
2,KECAMATAN,80966,HITADIPA,0,0,0
2,KECAMATAN,80970,WANDAI,0,0,0
2,KECAMATAN,80972,TIGI BARAT,0,0,0
2,KECAMATAN,80984,KEBO,0,0,0
2,KECAMATAN,80996,YATAMO,0,0,0
2,KECAMATAN,80953,DUMADAMA,0,0,0
2,KECAMATAN,80946,AGISIGA,0,0,0
2,KECAMATAN,80941,TIGI TIMUR,0,0,0
2,KECAMATAN,80871,PANIAI BARAT,0,0,0
2,KECAMATAN,80884,TIGI,0,0,0
2,KECAMATAN,80892,ARADIDE,0,0,0
2,KECAMATAN,80901,SUGAPA,0,0,0
2,KECAMATAN,80913,HOMEO,0,0,0
2,KECAMATAN,80924,BOGABAIDA,0,0,0
2,KECAMATAN,80931,BIANDOGA,0,0,0
2,KECAMATAN,80938,BIBIDA,0,0,0
2,KECAMATAN,81001,EKADIDE,0,0,0
1,KABUPATEN/KOTA,81007,MIMIKA,0,0,0
2,KECAMATAN,81008,MIMIKA BARU,0,0,0
2,KECAMATAN,81089,MIMIKA BARAT JAUH,0,0,0
2,KECAMATAN,81080,TEMBAGAPURA,0,0,0
2,KECAMATAN,81072,KUALA KENCANA,0,0,0
2,KECAMATAN,81066,MIMIKA TIMUR TENGAH,0,0,0
2,KECAMATAN,81060,MIMIKA TIMUR JAUH,0,0,0
2,KECAMATAN,81051,JILA,0,0,0
2,KECAMATAN,81045,JITA,0,0,0
2,KECAMATAN,81034,MIMIKA BARAT,0,0,0
2,KECAMATAN,81025,MIMIKA TIMUR,0,0,0
2,KECAMATAN,81020,AGIMUGA,0,0,0
2,KECAMATAN,81095,MIMIKA BARAT TENGAH,0,0,0
1,KABUPATEN/KOTA,81104,SARMI,0,0,0
2,KECAMATAN,81105,SARMI,0,0,0
2,KECAMATAN,81174,PANTAI TIMUR BAGIAN BARAT,0,0,0
2,KECAMATAN,81167,SARMI TIMUR,0,0,0
2,KECAMATAN,81161,SARMI SELATAN,0,0,0
2,KECAMATAN,81152,APAWER HULU,0,0,0
2,KECAMATAN,81141,BONGGO,0,0,0
2,KECAMATAN,81134,PANTAI TIMUR,0,0,0
2,KECAMATAN,81122,PANTAI BARAT,0,0,0
2,KECAMATAN,81113,TOR ATAS,0,0,0
2,KECAMATAN,81185,BONGGO TIMUR,0,0,0
1,KABUPATEN/KOTA,81192,KEEROM,0,0,0
2,KECAMATAN,81193,WARIS,0,0,0
2,KECAMATAN,81200,ARSO,0,0,0
2,KECAMATAN,81218,SENGGI,0,0,0
2,KECAMATAN,81225,WEB,0,0,0
2,KECAMATAN,81232,SKANTO,0,0,0
2,KECAMATAN,81241,ARSO TIMUR,0,0,0
2,KECAMATAN,81253,TOWE,0,0,0
1,KABUPATEN/KOTA,81261,PEGUNUNGAN BINTANG,0,0,0
2,KECAMATAN,81262,OKSIBIL,0,0,0
2,KECAMATAN,83660,TARUP,0,0,0
2,KECAMATAN,83661,OKHIKA,0,0,0
2,KECAMATAN,83662,OKSAMOL,0,0,0
2,KECAMATAN,83663,OKLIP,0,0,0
2,KECAMATAN,83664,OKBEMTAU,0,0,0
2,KECAMATAN,83665,OKSEBANG,0,0,0
2,KECAMATAN,83666,OKBAB,0,0,0
2,KECAMATAN,83667,BATANI,0,0,0
2,KECAMATAN,83668,WEIME,0,0,0
2,KECAMATAN,83669,MURKIM,0,0,0
2,KECAMATAN,83670,MOFINOP,0,0,0
2,KECAMATAN,83671,JETFA,0,0,0
2,KECAMATAN,83673,TEIRAPLU,0,0,0
2,KECAMATAN,83674,EIPUMEK,0,0,0
2,KECAMATAN,83675,PAMEK,0,0,0
2,KECAMATAN,83659,AWINBON,0,0,0
2,KECAMATAN,83658,KAWOR,0,0,0
2,KECAMATAN,81279,KIWIROK,0,0,0
2,KECAMATAN,81302,OKBIBAB,0,0,0
2,KECAMATAN,81318,IWUR,0,0,0
2,KECAMATAN,81332,BATOM,0,0,0
2,KECAMATAN,81342,BORME,0,0,0
2,KECAMATAN,83648,KIWIROK TIMUR,0,0,0
2,KECAMATAN,83649,ABOY,0,0,0
2,KECAMATAN,83650,PEPERA,0,0,0
2,KECAMATAN,83651,BIME,0,0,0
2,KECAMATAN,83652,ALEMSOM,0,0,0
2,KECAMATAN,83653,OKBAPE,0,0,0
2,KECAMATAN,83654,KALOMDOL,0,0,0
2,KECAMATAN,83655,OKSOP,0,0,0
2,KECAMATAN,83656,SERAMBAKON,0,0,0
2,KECAMATAN,83657,OK AOM,0,0,0
2,KECAMATAN,83676,NONGME,0,0,0
1,KABUPATEN/KOTA,81357,YAHUKIMO,0,0,0
2,KECAMATAN,81865,SUMO,0,0,0
2,KECAMATAN,81727,SELA,0,0,0
2,KECAMATAN,81718,SOLOIKMA,0,0,0
2,KECAMATAN,81709,LOLAT,0,0,0
2,KECAMATAN,81701,HOLUON,0,0,0
2,KECAMATAN,81695,DIRWEMNA,0,0,0
2,KECAMATAN,81693,KONA,0,0,0
2,KECAMATAN,81684,ENDOMEN,0,0,0
2,KECAMATAN,81682,PULDAMA,0,0,0
2,KECAMATAN,81672,TALAMBO,0,0,0
2,KECAMATAN,81660,UBALIHI,0,0,0
2,KECAMATAN,81744,KORUPUN,0,0,0
2,KECAMATAN,81757,LANGDA,0,0,0
2,KECAMATAN,81767,BOMELA,0,0,0
2,KECAMATAN,81857,KAYO,0,0,0
2,KECAMATAN,81849,YOGOSEM,0,0,0
2,KECAMATAN,81844,DURAM,0,0,0
2,KECAMATAN,81836,HILIPUK,0,0,0
2,KECAMATAN,81825,KWIKMA,0,0,0
2,KECAMATAN,81814,KWELEMDUA,0,0,0
2,KECAMATAN,81806,KABIANGGAMA,0,0,0
2,KECAMATAN,81792,SOBAHAM,0,0,0
2,KECAMATAN,81782,SEREDELA,0,0,0
2,KECAMATAN,81773,SUNTAMON,0,0,0
2,KECAMATAN,81656,HEREAPINI,0,0,0
2,KECAMATAN,81654,YAHULIAMBUT,0,0,0
2,KECAMATAN,81645,WALMA,0,0,0
2,KECAMATAN,81486,AMUMA,0,0,0
2,KECAMATAN,81481,WUSAMA,0,0,0
2,KECAMATAN,81468,SURU SURU,0,0,0
2,KECAMATAN,81456,OBIO,0,0,0
2,KECAMATAN,81443,DEKAI,0,0,0
2,KECAMATAN,81433,NALCA,0,0,0
2,KECAMATAN,81423,SAMENAGE,0,0,0
2,KECAMATAN,81402,SILIMO,0,0,0
2,KECAMATAN,81391,NINIA,0,0,0
2,KECAMATAN,81381,ANGGRUK,0,0,0
2,KECAMATAN,81500,MUSAIK,0,0,0
2,KECAMATAN,81511,PASEMA,0,0,0
2,KECAMATAN,81519,HOGIO,0,0,0
2,KECAMATAN,81636,PRONGGOLI,0,0,0
2,KECAMATAN,81618,UBAHAK,0,0,0
2,KECAMATAN,81614,NIPSAN,0,0,0
2,KECAMATAN,81602,KOSAREK,0,0,0
2,KECAMATAN,81588,PANGGEMA,0,0,0
2,KECAMATAN,81576,UKHA,0,0,0
2,KECAMATAN,81565,TANGMA,0,0,0
2,KECAMATAN,81550,WERIMA,0,0,0
2,KECAMATAN,81543,SOBA,0,0,0
2,KECAMATAN,81528,MUGI,0,0,0
2,KECAMATAN,81358,KURIMA,0,0,0
1,KABUPATEN/KOTA,78324,TOLIKARA,0,0,0
2,KECAMATAN,83904,YUKO,0,0,0
2,KECAMATAN,83874,WAKUWO,0,0,0
2,KECAMATAN,83873,YUNERI,0,0,0
2,KECAMATAN,83872,TAGINERI,0,0,0
2,KECAMATAN,78850,DOW,0,0,0
2,KECAMATAN,78821,AIRGARAM,0,0,0
2,KECAMATAN,78808,KAMBONERI,0,0,0
2,KECAMATAN,78788,POGANERI,0,0,0
2,KECAMATAN,78776,EGIAM,0,0,0
2,KECAMATAN,83875,GIKA,0,0,0
2,KECAMATAN,83876,TELENGGEME,0,0,0
2,KECAMATAN,83877,ANAWI,0,0,0
2,KECAMATAN,83903,BIUK,0,0,0
2,KECAMATAN,83902,LI ANOGOMMA,0,0,0
2,KECAMATAN,83901,BOGONUK,0,0,0
2,KECAMATAN,83900,AWEKU,0,0,0
2,KECAMATAN,83899,KAI,0,0,0
2,KECAMATAN,83898,TAGIME,0,0,0
2,KECAMATAN,83897,DANIME,0,0,0
2,KECAMATAN,83896,WUGI,0,0,0
2,KECAMATAN,83895,WENAM,0,0,0
2,KECAMATAN,78755,GEYA,0,0,0
2,KECAMATAN,78740,DUNDU,0,0,0
2,KECAMATAN,78480,WONIKI,0,0,0
2,KECAMATAN,78466,PANAGA,0,0,0
2,KECAMATAN,78453,UMAGI,0,0,0
2,KECAMATAN,78439,WINA,0,0,0
2,KECAMATAN,78424,WUNIM,0,0,0
2,KECAMATAN,78404,GOYAGE,0,0,0
2,KECAMATAN,78386,KEMBU,0,0,0
2,KECAMATAN,78367,KANGGIME,0,0,0
2,KECAMATAN,78352,BOKONDINI,0,0,0
2,KECAMATAN,78501,KUBU,0,0,0
2,KECAMATAN,78546,NELAWI,0,0,0
2,KECAMATAN,78725,TIMORI,0,0,0
2,KECAMATAN,78707,NUMBA,0,0,0
2,KECAMATAN,78688,GUNDAGI,0,0,0
2,KECAMATAN,78661,NUNGGAWI,0,0,0
2,KECAMATAN,78647,GILUBANDU,0,0,0
2,KECAMATAN,78621,NABUNAGE,0,0,0
2,KECAMATAN,78606,BEWANI,0,0,0
2,KECAMATAN,78588,BOKONERI,0,0,0
2,KECAMATAN,78569,KUARI,0,0,0
2,KECAMATAN,78325,KARUBAGA,0,0,0
1,KABUPATEN/KOTA,78862,WAROPEN,0,0,0
2,KECAMATAN,78863,INGGERUS,281,924,1205
2,KECAMATAN,78877,MASIREI,99,1208,1307
2,KECAMATAN,78886,RISEI SAYATI,139,934,1073
2,KECAMATAN,78890,WAPOGA,0,0,0
2,KECAMATAN,78897,WAROPEN BAWAH,625,2441,3066
2,KECAMATAN,78910,KIRIHI,552,2147,2699
2,KECAMATAN,84096,UREI FAISEI,980,4873,5853
2,KECAMATAN,84097,OUDATE,94,2497,2591
2,KECAMATAN,84098,DEMBA,151,1963,2114
1,KABUPATEN/KOTA,78927,BOVEN DIGOEL,2921,16987,19908
2,KECAMATAN,78928,MANDOBO,0,0,0
2,KECAMATAN,83684,MANGGELUM,0,0,0
2,KECAMATAN,83685,FIRIWAGE,0,0,0
2,KECAMATAN,83686,YANIRUMA,0,0,0
2,KECAMATAN,83687,SUBUR,0,0,0
2,KECAMATAN,83688,KOMBAY,0,0,0
2,KECAMATAN,83690,NINATI,0,0,0
2,KECAMATAN,83691,SESNUK,0,0,0
2,KECAMATAN,83692,KI,0,0,0
2,KECAMATAN,83682,AMBATKWI,0,0,0
2,KECAMATAN,83680,FOFI,0,0,0
2,KECAMATAN,78942,MINDIPTANA,0,0,0
2,KECAMATAN,78964,WAROPKO,0,0,0
2,KECAMATAN,78979,KOUH,0,0,0
2,KECAMATAN,78998,JAIR,0,0,0
2,KECAMATAN,79009,BOMAKIA,0,0,0
2,KECAMATAN,83677,KOMBUT,0,0,0
2,KECAMATAN,83678,INIYANDIT,0,0,0
2,KECAMATAN,83679,ARIMOP,0,0,0
2,KECAMATAN,83694,KAWAGIT,0,0,0
1,KABUPATEN/KOTA,79019,MAPPI,0,0,0
2,KECAMATAN,79020,OBAA,2159,9062,11221
2,KECAMATAN,83702,PASSUE BAWAH,823,903,1726
2,KECAMATAN,83700,BAMGI,102,1048,1150
2,KECAMATAN,83699,YAKOMI,160,776,936
2,KECAMATAN,83698,SYAHCAME,133,1244,1377
2,KECAMATAN,79152,VENAHA,157,1032,1189
2,KECAMATAN,79141,MINYAMUR,942,1653,2595
2,KECAMATAN,79131,PASSUE,235,2238,2473
2,KECAMATAN,79119,KAIBAR,242,768,1010
2,KECAMATAN,79103,ASSUE,571,3626,4197
2,KECAMATAN,79084,HAJU,423,4907,5330
2,KECAMATAN,79065,EDERA,658,2032,2690
2,KECAMATAN,79038,NAMBIOMAN BAPAI,397,2588,2985
2,KECAMATAN,83704,TI  ZAIN,688,2195,2883
1,KABUPATEN/KOTA,79163,ASMAT,7690,34072,41762
2,KECAMATAN,79164,AGATS,0,0,0
2,KECAMATAN,83719,UNIR SIRAU,0,0,0
2,KECAMATAN,83717,KOLF BRAZA,0,0,0
2,KECAMATAN,83714,BETCBAMU,0,0,0
2,KECAMATAN,83713,AYIP,0,0,0
2,KECAMATAN,83712,SIRETS,0,0,0
2,KECAMATAN,83711,SAFAN,0,0,0
2,KECAMATAN,83710,KOPAY,0,0,0
2,KECAMATAN,83709,DER KOUMUR,0,0,0
2,KECAMATAN,83707,PULAU TIGA,0,0,0
2,KECAMATAN,83706,JOERAT,0,0,0
2,KECAMATAN,79293,SUATOR,0,0,0
2,KECAMATAN,79257,PANTAI KASUARI,0,0,0
2,KECAMATAN,79244,FAYIT,0,0,0
2,KECAMATAN,79234,AKAT,0,0,0
2,KECAMATAN,79197,SAWA ERMA,0,0,0
2,KECAMATAN,79174,ATSJ,0,0,0
2,KECAMATAN,84099,JETSY,0,0,0
1,KABUPATEN/KOTA,79310,SUPIORI,0,0,0
2,KECAMATAN,79311,SUPIORI SELATAN,0,0,0
2,KECAMATAN,79319,SUPIORI UTARA,0,0,0
2,KECAMATAN,79325,SUPIORI TIMUR,0,0,0
2,KECAMATAN,79336,KEPULAUAN ARURI,0,0,0
2,KECAMATAN,79346,SUPIORI BARAT,0,0,0
1,KABUPATEN/KOTA,79354,MAMBERAMO RAYA,0,0,0
2,KECAMATAN,79355,MAMBERAMO TENGAH,0,0,0
2,KECAMATAN,79367,MAMBERAMO HULU,0,0,0
2,KECAMATAN,79376,RUFAER,0,0,0
2,KECAMATAN,79383,MAMBERAMO TENGAH TIMUR,0,0,0
2,KECAMATAN,79391,MAMBERAMO HILIR,0,0,0
2,KECAMATAN,79399,WAROPEN ATAS,0,0,0
2,KECAMATAN,79408,BENUKI,0,0,0
2,KECAMATAN,79415,SAWAI,0,0,0
1,KABUPATEN/KOTA,79466,MAMBERAMO TENGAH,0,0,0
2,KECAMATAN,79467,KOBAGMA,0,0,0
2,KECAMATAN,79483,KELILA,0,0,0
2,KECAMATAN,79503,ERAGAYAM,0,0,0
2,KECAMATAN,79519,MEGAMBILIS,0,0,0
2,KECAMATAN,79524,ILUGWA,0,0,0
1,KABUPATEN/KOTA,79531,YALIMO,0,0,0
2,KECAMATAN,79532,ELELIM,0,0,0
2,KECAMATAN,79537,APALAPSILI,0,0,0
2,KECAMATAN,79542,ABENAHO,0,0,0
2,KECAMATAN,79553,BENAWA,0,0,0
2,KECAMATAN,79558,WELAREK,0,0,0
1,KABUPATEN/KOTA,79564,LANNY JAYA,0,0,0
2,KECAMATAN,83720,TIOM,0,0,0
2,KECAMATAN,83728,KUYAWAGE,0,0,0
2,KECAMATAN,83727,TIOMNERI,0,0,0
2,KECAMATAN,83726,BALINGGA,0,0,0
2,KECAMATAN,83725,MELAGINERI,0,0,0
2,KECAMATAN,83724,DIMBA,0,0,0
2,KECAMATAN,83723,GAMELIA,0,0,0
2,KECAMATAN,83722,MAKKI,0,0,0
2,KECAMATAN,83721,PIRIME,0,0,0
2,KECAMATAN,83863,POGA,0,0,0
1,KABUPATEN/KOTA,79629,NDUGA,0,0,0
2,KECAMATAN,79630,KENYAM,0,0,0
2,KECAMATAN,83739,DAL,0,0,0
2,KECAMATAN,83740,NIRKURI,0,0,0
2,KECAMATAN,83741,INIKGAL,0,0,0
2,KECAMATAN,83742,INIYE,0,0,0
2,KECAMATAN,83743,MBULMU YALMA,0,0,0
2,KECAMATAN,83744,MBUA TENGAH,0,0,0
2,KECAMATAN,83745,EMBETPEN,0,0,0
2,KECAMATAN,83746,KORA,0,0,0
2,KECAMATAN,83747,WUSI,0,0,0
2,KECAMATAN,83748,PIJA,0,0,0
2,KECAMATAN,83749,MOBA,0,0,0
2,KECAMATAN,83750,WUTPAGA,0,0,0
2,KECAMATAN,83751,NENGGEAGIN,0,0,0
2,KECAMATAN,83752,PASIR PUTIH,0,0,0
2,KECAMATAN,83738,MAM,0,0,0
2,KECAMATAN,83737,YAL,0,0,0
2,KECAMATAN,79632,MAPENDUMA,0,0,0
2,KECAMATAN,79637,YIGI,0,0,0
2,KECAMATAN,79642,WOSAK,0,0,0
2,KECAMATAN,79647,MUGI,0,0,0
2,KECAMATAN,79651,MBUWA,0,0,0
2,KECAMATAN,79656,GESELMA,0,0,0
2,KECAMATAN,79661,GEAREK,0,0,0
2,KECAMATAN,83730,KOROPTAK,0,0,0
2,KECAMATAN,83731,KEGAYEM,0,0,0
2,KECAMATAN,83732,PARO,0,0,0
2,KECAMATAN,83733,MEBAROK,0,0,0
2,KECAMATAN,83734,YENGGELO,0,0,0
2,KECAMATAN,83735,KILMID,0,0,0
2,KECAMATAN,83736,ALAMA,0,0,0
2,KECAMATAN,83753,KREPKURI,0,0,0
1,KABUPATEN/KOTA,79663,PUNCAK,0,0,0
2,KECAMATAN,79664,ILAGA,3564,27306,30870
2,KECAMATAN,79680,WANGBE,0,20021,20021
2,KECAMATAN,79692,BEOGA,0,25832,25832
2,KECAMATAN,79705,DOUFO,0,6108,6108
2,KECAMATAN,79711,POGOMA,31,14963,14994
2,KECAMATAN,79722,SINAK,0,28061,28061
2,KECAMATAN,79735,AGANDUGUME,0,11408,11408
2,KECAMATAN,79739,GOME,4476,15397,19873
1,KABUPATEN/KOTA,79752,DOGIYAI,8071,149096,157167
2,KECAMATAN,79753,KAMU,0,0,0
2,KECAMATAN,83756,MAPIA BARAT,0,0,0
2,KECAMATAN,83755,PIYAIYE,0,0,0
2,KECAMATAN,83754,MAPIA,0,0,0
2,KECAMATAN,79819,MAPIA TENGAH,0,0,0
2,KECAMATAN,79811,KAMU TIMUR,0,0,0
2,KECAMATAN,79803,KAMU SELATAN,0,0,0
2,KECAMATAN,79782,SUKIKAI SELATAN,0,0,0
2,KECAMATAN,79777,KAMU UTARA,0,0,0
2,KECAMATAN,83759,DOGIYAI,0,0,0
1,KABUPATEN/KOTA,78204,INTAN JAYA,0,0,0
2,KECAMATAN,78205,SUGAPA,0,0,0
2,KECAMATAN,78222,HOMEYO,0,0,0
2,KECAMATAN,78241,WANDAI,0,0,0
2,KECAMATAN,78251,BIANDOGA,0,0,0
2,KECAMATAN,78267,AGISIGA,0,0,0
2,KECAMATAN,78280,HITADIPA,0,0,0
1,KABUPATEN/KOTA,78289,DEIYAI,0,0,0
2,KECAMATAN,78290,TIGI,0,0,0
2,KECAMATAN,78298,TIGI TIMUR,0,0,0
2,KECAMATAN,78305,BOWOBADO,0,0,0
2,KECAMATAN,78309,TIGI BARAT,0,0,0
2,KECAMATAN,78322,KAPIRAYA,0,0,0
1,KABUPATEN/KOTA,79421,KOTA JAYAPURA,0,0,0
2,KECAMATAN,79422,JAYAPURA UTARA,0,0,0
2,KECAMATAN,79431,JAYAPURA SELATAN,0,0,0
2,KECAMATAN,79439,ABEPURA,0,0,0
2,KECAMATAN,79451,MUARA TAMI,0,0,0
2,KECAMATAN,79460,HERAM,0,0,0
0,PROVINSI,81877,PAPUA BARAT,0,0,0
1,KABUPATEN/KOTA,82022,SORONG,0,0,0
2,KECAMATAN,82023,MAKBON,61,1315,1376
2,KECAMATAN,82141,KLASO,30,1338,1368
2,KECAMATAN,82137,KLAYILI,53,961,1014
2,KECAMATAN,82131,MARIAT,4378,2826,7204
2,KECAMATAN,82127,MAUDUS,322,1057,1379
2,KECAMATAN,82117,KLAWAK,176,2019,2195
2,KECAMATAN,82109,KLABOT,265,2245,2510
2,KECAMATAN,82103,SALAWATI SELATAN,424,902,1326
2,KECAMATAN,82095,MAYAMUK,4256,2243,6499
2,KECAMATAN,82088,SEGUN,286,810,1096
2,KECAMATAN,82082,SAYOSA,238,1661,1899
2,KECAMATAN,82068,KLAMONO,1039,3196,4235
2,KECAMATAN,82059,AIMAS,6833,6967,13800
2,KECAMATAN,82051,SEGET,483,1552,2035
2,KECAMATAN,82044,SALAWATI,4136,1497,5633
2,KECAMATAN,82038,BERAUR,584,2096,2680
2,KECAMATAN,82146,MOISEGEN,743,829,1572
1,KABUPATEN/KOTA,82154,MANOKWARI,24307,33514,57821
2,KECAMATAN,82155,RANSIKI,0,0,0
2,KECAMATAN,82451,NENEY,0,0,0
2,KECAMATAN,82467,TOHOTA,0,0,0
2,KECAMATAN,82472,SIDEY,0,0,0
2,KECAMATAN,82489,TAIGE,0,0,0
2,KECAMATAN,82501,MEMBEY,0,0,0
2,KECAMATAN,82509,ANGGI GIDA,0,0,0
2,KECAMATAN,82517,DIDOHU,0,0,0
2,KECAMATAN,82532,DATARAN ISIM,0,0,0
2,KECAMATAN,82553,CATUBOUW,0,0,0
2,KECAMATAN,82426,TANAH RUBUH,0,0,0
2,KECAMATAN,82410,TESTEGA,0,0,0
2,KECAMATAN,82391,MANOKWARI SELATAN,0,0,0
2,KECAMATAN,82169,WARMARE,0,0,0
2,KECAMATAN,82188,PRAFI,0,0,0
2,KECAMATAN,82205,MASNI,0,0,0
2,KECAMATAN,82239,ORANSBARI,0,0,0
2,KECAMATAN,82263,ANGGI,0,0,0
2,KECAMATAN,82277,SURUREY,0,0,0
2,KECAMATAN,82298,MINYAMBOUW,0,0,0
2,KECAMATAN,82349,MANOKWARI BARAT,0,0,0
2,KECAMATAN,82360,MANOKWARI TIMUR,0,0,0
2,KECAMATAN,82368,MANOKWARI UTARA,0,0,0
2,KECAMATAN,82575,HINK,0,0,0
1,KABUPATEN/KOTA,82605,FAKFAK,0,0,0
2,KECAMATAN,82641,KOKAS,0,0,0
2,KECAMATAN,82674,KARAS,0,0,0
2,KECAMATAN,82682,BOMBERAY,0,0,0
2,KECAMATAN,82692,KRAMONGMONGGA,0,0,0
2,KECAMATAN,82707,TELUK PATIPI,0,0,0
1,KABUPATEN/KOTA,82724,SORONG SELATAN,0,0,0
2,KECAMATAN,82725,TEMINABUAN,0,0,0
2,KECAMATAN,82835,SAIFI,83,1514,1597
2,KECAMATAN,82828,KOKODA UTARA,0,0,0
2,KECAMATAN,82821,METEMANI,0,0,0
2,KECAMATAN,82815,KONDA,0,0,0
2,KECAMATAN,82802,KAIS,0,0,0
2,KECAMATAN,82793,WAYER,0,0,0
2,KECAMATAN,82785,SEREMUK,207,1007,1214
2,KECAMATAN,82778,MOSWAREN,0,0,0
2,KECAMATAN,82762,KOKODA,0,0,0
2,KECAMATAN,82749,SAWIAT,0,0,0
2,KECAMATAN,82741,INANWATAN,431,1293,1724
2,KECAMATAN,82845,FKOUR,216,466,682
1,KABUPATEN/KOTA,82850,RAJA AMPAT,937,4280,5217
2,KECAMATAN,82948,WAIGEO BARAT KEPULAUAN,0,0,0
2,KECAMATAN,82954,MISOOL BARAT,0,0,0
2,KECAMATAN,82960,KEPULAUAN SEMBILAN,0,0,0
2,KECAMATAN,83557,KOTA WAISAI,0,0,0
2,KECAMATAN,83558,TIPLOL MAYALIBIT,0,0,0
2,KECAMATAN,83559,BATANTA UTARA,0,0,0
2,KECAMATAN,83560,SALAWATI BARAT,0,0,0
2,KECAMATAN,83561,SALAWATI TENGAH,0,0,0
2,KECAMATAN,83562,SUPNIN,0,0,0
2,KECAMATAN,83563,KEPULAUAN AYAU,0,0,0
2,KECAMATAN,82943,WARWARBOMI,0,0,0
2,KECAMATAN,82938,MISOOL SELATAN,0,0,0
2,KECAMATAN,82857,WAIGEO UTARA,0,0,0
2,KECAMATAN,82864,WAIGEO SELATAN,0,0,0
2,KECAMATAN,82871,SALAWATI UTARA,0,0,0
2,KECAMATAN,82882,AYAU,0,0,0
2,KECAMATAN,82890,MISOOL TIMUR,0,0,0
2,KECAMATAN,82895,WAIGEO BARAT,0,0,0
2,KECAMATAN,82901,WAIGEO TIMUR,0,0,0
2,KECAMATAN,82906,TELUK MAYALIBIT,0,0,0
2,KECAMATAN,82917,KOFIAU,0,0,0
2,KECAMATAN,82922,MEOS MANSAR,0,0,0
2,KECAMATAN,83564,BATANTA SELATAN,0,0,0
1,KABUPATEN/KOTA,82965,TELUK BINTUNI,0,0,0
2,KECAMATAN,82966,BINTUNI,2959,7845,10804
2,KECAMATAN,83046,SUMURI,1277,3953,5230
2,KECAMATAN,83052,KAITARO,66,532,598
2,KECAMATAN,83058,AROBA,443,1435,1878
2,KECAMATAN,83064,MASYETA,136,552,688
2,KECAMATAN,83069,BISCOOP,53,454,507
2,KECAMATAN,83077,TOMU,1199,370,1569
2,KECAMATAN,83082,KAMUNDAN,305,189,494
2,KECAMATAN,83087,WERIAGAR,644,701,1345
2,KECAMATAN,83093,MOSKONA BARAT,5,757,762
2,KECAMATAN,83098,MEYADO,164,557,721
2,KECAMATAN,83039,DATARAN BEIMES,23,958,981
2,KECAMATAN,83033,TUHIBA,171,703,874
2,KECAMATAN,82975,MERDEY,573,391,964
2,KECAMATAN,82985,BABO,778,1205,1983
2,KECAMATAN,82990,ARANDAY,957,377,1334
2,KECAMATAN,82995,MOSKONA SELATAN,154,800,954
2,KECAMATAN,83001,MOSKONA UTARA,187,1017,1204
2,KECAMATAN,83006,WAMESA,0,796,796
2,KECAMATAN,83011,FAFURWAR,6,869,875
2,KECAMATAN,83015,TEMBUNI,223,550,773
2,KECAMATAN,83020,KURI,45,698,743
2,KECAMATAN,83026,MANIMERI,1240,2011,3251
2,KECAMATAN,83103,MOSKONA TIMUR,706,779,1485
1,KABUPATEN/KOTA,83107,TELUK WONDAMA,12314,28499,40813
2,KECAMATAN,83108,WASIOR,0,0,0
2,KECAMATAN,83181,ROSWAR,0,0,0
2,KECAMATAN,83175,NIKIWAR,84,471,555
2,KECAMATAN,83168,KURI WAMESA,0,0,0
2,KECAMATAN,83162,SOUG JAYA,0,0,0
2,KECAMATAN,83157,WONDIBOY,243,1085,1328
2,KECAMATAN,83151,NAIKERE,0,0,0
2,KECAMATAN,83144,RUMBERPON,0,0,0
2,KECAMATAN,83140,WAMESA,0,0,0
2,KECAMATAN,83130,RASIEI,0,0,0
2,KECAMATAN,83125,TELUK DUAIRI,367,684,1051
2,KECAMATAN,83119,WINDESI,0,0,0
2,KECAMATAN,83186,ROON,0,0,0
1,KABUPATEN/KOTA,83194,KAIMANA,694,2240,2934
2,KECAMATAN,83195,KAIMANA,0,0,0
2,KECAMATAN,83215,BURUWAY,0,0,0
2,KECAMATAN,83226,TELUK ARGUNI ATAS,0,0,0
2,KECAMATAN,83252,TELUK ETNA,0,0,0
2,KECAMATAN,83258,KAMBRAU,0,0,0
2,KECAMATAN,83266,TELUK ARGUNI BAWAH,0,0,0
2,KECAMATAN,83282,YAMOR,0,0,0
1,KABUPATEN/KOTA,81992,TAMBRAUW,0,0,0
2,KECAMATAN,81993,FEF,0,0,0
2,KECAMATAN,83569,MUBRANI,0,0,0
2,KECAMATAN,83568,SENOPI,0,0,0
2,KECAMATAN,83567,KEBAR,0,0,0
2,KECAMATAN,83566,AMBERBAKEN,0,0,0
2,KECAMATAN,83565,SYUJAK,0,0,0
2,KECAMATAN,82017,ABUN,0,0,0
2,KECAMATAN,82009,SAUSAPOR,0,0,0
2,KECAMATAN,82006,KWOOR,0,0,0
2,KECAMATAN,82001,YEMBUN,0,0,0
2,KECAMATAN,81995,MIYAH,0,0,0
2,KECAMATAN,83570,MORAID,0,0,0
1,KABUPATEN/KOTA,81878,MAYBRAT,0,0,0
2,KECAMATAN,81879,AIFAT,1049,1250,2299
2,KECAMATAN,83573,AYAMARU SELATAN,245,1076,1321
2,KECAMATAN,83574,AYAMARU JAYA,62,1191,1253
2,KECAMATAN,83575,AYAMARU UTARA TIMUR,276,852,1128
2,KECAMATAN,83576,AYAMARU TIMUR SELATAN,118,540,658
2,KECAMATAN,83577,AYAMARU SELATAN JAYA,313,649,962
2,KECAMATAN,83578,AITINYO TENGAH,201,804,1005
2,KECAMATAN,83579,AITINYO RAYA,53,956,1009
2,KECAMATAN,83580,MARE SELATAN,698,252,950
2,KECAMATAN,83581,AIFAT TIMUR TENGAH,573,441,1014
2,KECAMATAN,83582,AIFAT TIMUR JAUH,199,242,441
2,KECAMATAN,83572,AYAMARU TENGAH,269,1149,1418
2,KECAMATAN,83571,AYAMARU BARAT,70,649,719
2,KECAMATAN,81890,AIFAT UTARA,761,1273,2034
2,KECAMATAN,81901,AIFAT TIMUR,392,353,745
2,KECAMATAN,81911,AIFAT SELATAN,575,796,1371
2,KECAMATAN,81919,AITINYO BARAT,306,584,890
2,KECAMATAN,81927,AITINYO,195,1649,1844
2,KECAMATAN,81940,AITINYO UTARA,143,933,1076
2,KECAMATAN,81951,AYAMARU,124,1717,1841
2,KECAMATAN,81969,AYAMARU UTARA,778,1449,2227
2,KECAMATAN,81978,AYAMARU TIMUR,140,871,1011
2,KECAMATAN,81984,MARE,346,866,1212
2,KECAMATAN,83583,AIFAT TIMUR SELATAN,77,340,417
1,KABUPATEN/KOTA,83289,KOTA SORONG,7963,20882,28845
2,KECAMATAN,83290,SORONG,0,0,0
2,KECAMATAN,83296,SORONG TIMUR,6841,9561,16402
2,KECAMATAN,83303,SORONG BARAT,0,0,0
2,KECAMATAN,83309,SORONG KEPULAUAN,1440,2596,4036
2,KECAMATAN,83314,SORONG UTARA,0,0,0
